Il y avait	French	4.5
vers l'an à	French	2.5
quelques centaines de	French	4.5
pas de une	French	4.5
maisonnette assez bien	French	4.5
bâtie dont la	French	4.5
porte s'ouvrait sur	French	4.5
le grand chemin	English	English
de haie vive	English	English
d'aubépine et de	French	4.5
sureau entourait un	French	4.5
jardin où l'on	French	1.5
voyait pêlemêle des	French	4.5
fleurs des chèvres	French	4.5
et des enfants	English	English
Une demidouzaine de	French	4.5
poules avec leurs	French	4.5
poussins caquetaient dans	French	4.5
un coin entre	French	4.5
les choux et	French	4.5
les fraisiers deux	French	4.5
ou trois ruches	English	English
groupées sous des	French	4.5
pêchers tournaient vers	English	English
le soleil leurs	French	4.5
cônes odorants tout	French	2.5
bourdonnants d'abeilles et	French	4.5
çà et là	French	4.5
sur les branches	English	English
de gros poiriers	English	English
chargés de fruits	English	English
roucoulait quelque beau	French	2.5
ramier qui battait	French	0.5
de l'aile autour	French	4.5
de sa compagne	French	4.5
La maisonnette avait	French	4.5
un aspect frais	French	4.5
et souriant qui	French	4.5
réjouissait le coeur	English	English
la vigne vierge	French	0.5
et le houblon	English	English
tapissaient ses murs	English	English
sept ou huit	French	4.5
fenêtres percées irrégulièrement	French	4.5
et toutes grandes	French	4.5
ouvertes au midi	English	English
semblaient regarder la	French	4.5
campagne avec bonhomie	French	2.5
un mince filet	English	English
de fumée tremblait	French	0.5
au bout de	French	4.5
la cheminée où	French	4.5
pendaient les tiges	English	English
flexibles des pariétaires	French	4.5
et à quelque	French	4.5
heure du jour	French	4.5
que l'on passât	French	4.5
devant la maisonnette	French	4.5
on y entendait	French	4.5
des cris joyeux	French	4.5
d'enfants mêlés au	French	4.5
chant du coq	French	4.5
ces enfants qui	French	4.5
venaient là de	French	4.5
tous les coins	English	English
du faubourg il	French	2.5
y en avait	French	4.5
trois qui appartenaient	French	4.5
à le maître	French	4.5
du logis et	French	4.5
Guillaume ou le	French	4.5
père comme on	English	English
l'appelait familièrement était	French	4.5
bien le meilleur	French	4.5
fauconnier qu'il y	French	0.5
eût dans tout	French	2.5
l'Artois mais depuis	French	4.5
longtemps déjà il	French	2.5
n'avait guère eu	French	0.5
l'occasion d'exercer son	French	4.5
savoir la régence	French	4.5
de la reine	English	English
d'Autriche le seigneur	English	English
d'Assonville son maître	French	4.5
ruiné par les	French	4.5
guerres avait été	French	4.5
contraint de vendre	French	4.5
ses terres mais	French	4.5
avant de quitter	English	English
le pays voulant	French	4.5
récompenser la fidélité	French	4.5
de son vieux	French	4.5
serviteur il lui	French	4.5
avait fait présent	French	4.5
de la maisonnette	French	4.5
et du jardin	French	0.5
vieux se refusant	English	English
à servir de	French	4.5
nouveaux maîtres s'était	French	4.5
retiré dans cette	French	4.5
habitation où il	French	2.5
vivait du produit	French	4.5
de quelques travaux	French	4.5
et de ses	French	4.5
épargnes veuf le	French	4.5
père ne pensait	French	0.5
plus qu'à ses	French	4.5
enfants qu'il élevait	French	4.5
aussi bien que	French	4.5
ses moyens le	French	4.5
lui permettaient et	French	4.5
le plus honnêtement	French	4.5
du monde Tant	French	2.5
qu'ils furent petits	English	English
les enfants vécurent	French	4.5
aussi libres que	French	4.5
des papillons se	French	2.5
roulant sur l'herbe	French	1.5
en été patinant	French	0.5
sur la glace	English	English
en hiver et	French	4.5
courant tête nue	French	1.5
au soleil par	French	4.5
la pluie ou	French	4.5
par le vent	French	4.5
arriva le temps	French	2.5
des études qui	French	4.5
consistaient à lire	French	4.5
dans un grand	English	English
livre sur les	French	4.5
genoux du bonhomme	French	2.5
et à écrire	French	4.5
sur une ardoise	English	English
ce qui n'empêchait	French	4.5
pas qu'on trouvât	French	4.5
encore le loisir	French	1.5
de ramasser les	French	4.5
fraises dans les	French	4.5
bois et les	French	4.5
écrevisses dans les	French	4.5
ruisseaux Jacques l'aîné	French	4.5
de la famille	English	English
était à dixsept	French	1.5
ou dixhuit ans	English	English
un grand garçon	French	4.5
qui paraissait en	French	4.5
avoir plus de	French	4.5
vingt n'était pas	French	4.5
beau parleur mais	French	4.5
il agissait avec	French	2.5
une hardiesse et	French	4.5
une résolution extrêmes	French	4.5
aussitôt qu'il croyait	French	1.5
être dans son	French	4.5
droit force le	French	4.5
faisait redouter de	French	4.5
tous les écoliers	French	4.5
du faubourg et	French	4.5
de la banlieue	French	2.5
comme sa droiture	French	4.5
l'en faisait aimer	French	0.5
le prenait volontiers	French	4.5
pour juge dans	French	4.5
toutes les querelles	French	4.5
d'enfants rendait son	French	4.5
arrêt l'appuyait au	French	4.5
besoin de quelques	French	4.5
bons coups de	French	4.5
poing et tout	French	2.5
le monde s'en	French	0.5
retournait content Quand	English	English
il y avait	French	4.5
une dispute et	French	4.5
des batailles pour	French	4.5
des cerises ou	French	4.5
quelque toupie d'Allemagne	French	1.5
aussitôt qu'on voyait	French	1.5
arriver les plus	French	4.5
tapageurs se taisaient	French	4.5
et les plus	French	4.5
faibles se redressaient	English	English
écartait les combattants	English	English
se faisait rendre	French	2.5
compte des causes	English	English
du débat distribuait	French	4.5
un conseil aux	French	4.5
uns une taloche	French	2.5
aux autres adjugeait	English	English
l'objet en litige	English	English
et mettait chacun	French	2.5
d'accord par une	French	4.5
partie de quilles	French	4.5
Il lui arrivait	French	0.5
parfois de s'adresser	French	4.5
à plus grand	English	English
et plus fort	English	English
que lui mais	French	4.5
la crainte d'être	French	4.5
battu ne l'arrêtait	French	4.5
pas fois terrassé	French	0.5
il se relevait	French	0.5
dix fois vaincu	French	4.5
la veille il	French	2.5
recommençait le lendemain	English	English
et tel était	French	4.5
l'empire de son	French	4.5
courage appuyé sur	French	4.5
le sentiment de	French	4.5
la justice inné	French	4.5
en lui qu'il	French	4.5
finissait toujours par	French	4.5
l'emporter ce petit	English	English
garçon déterminé qui	French	4.5
n'aurait pas reculé	French	0.5
devant dix gendarmes	English	English
du roi se	French	2.5
troublait et balbutiait	English	English
devant une petite	English	English
fille qui pouvait	French	4.5
bien avoir quatre	French	0.5
ans de moins	French	4.5
que lui suffisait	French	4.5
de la présence	French	4.5
de Suzanne de	French	4.5
pour l'arrêter au	French	4.5
beau milieu de	French	4.5
ses exercices les	French	4.5
plus violents qu'il	French	4.5
l'apercevait il dégringolait	French	1.5
du haut des	French	4.5
peupliers où il	French	2.5
dénichait les pies	English	English
lâchait le bras	English	English
du méchant drôle	French	4.5
qu'il était en	French	4.5
train de corriger	English	English
ou laissait aller	English	English
le taureau contre	French	4.5
lequel il luttait	French	1.5
ne fallait à	French	2.5
la demoiselle qu'un	French	4.5
signe imperceptible de	French	4.5
son doigt rien	French	4.5
qu'un regard pour	French	4.5
faire accourir à	French	2.5
son côté tout	French	2.5
rouge et tout	French	2.5
confus Le père	French	4.5
de de était	French	4.5
un riche traitant	French	4.5
qui avait profité	French	0.5
pour faire fortune	English	English
du temps de	French	4.5
la où tant	French	2.5
d'autres se ruinèrent	French	0.5
ne s'était pas	French	4.5
toujours appelé du	French	4.5
nom brillant de	French	4.5
Malzonvilliers qui était	French	4.5
celui d'une terre	French	2.5
où il avait	French	4.5
mis le plus	French	4.5
clair de son	French	4.5
bien mais en	French	4.5
homme avisé il	French	2.5
avait pensé qu'il	French	4.5
pouvait ainsi que	French	4.5
d'autres bourgeois de	French	4.5
sa connaissance troquer	French	4.5
le nom roturier	English	English
de son père	French	4.5
contre un nom	English	English
qui fit honneur	English	English
à ses écus	French	0.5
était devenu progressivement	English	English
et par une	French	4.5
suite de transformations	English	English
habiles d'abord du	French	4.5
puis du de	French	4.5
puis enfin M	French	0.5
de tout court	English	English
il n'attendait plus	French	4.5
que l'occasion favorable	French	4.5
de se donner	French	4.5
un titre baron	English	English
ou chevalier l'époque	French	4.5
où ses affaires	French	4.5
nécessitaient de fréquents	French	4.5
voyages dans la	French	4.5
province et souvent	French	4.5
même jusqu'à de	French	4.5
avait maintes fois	French	4.5
confié la gestion	French	4.5
de ses biens	French	4.5
à qui passait	French	4.5
pour le plus	French	4.5
honnête artisan de	French	4.5
confiance dont de	French	4.5
s'était toujours bien	French	4.5
trouvé avait établi	French	4.5
entre le fauconnier	French	4.5
et le traitant	French	4.5
des relations intimes	English	English
et journalières qui	French	4.5
profitèrent aux trois	French	4.5
enfants et Pierre	French	1.5
qui était à	French	2.5
peu près de	French	4.5
l'âge de avait	French	4.5
des maîtres de	French	4.5
toute espèce et	French	4.5
les leçons servaient	French	4.5
à tout le	French	4.5
monde si bien	French	4.5
que les fils	English	English
du père en	French	4.5
surent bientôt plus	French	4.5
long que la	French	4.5
moitié des petits	English	English
bourgeois de Jacques	English	English
profitait surtout de	French	4.5
cet enseignement comme	French	4.5
il avait l'esprit	English	English
juste et persévérant	French	4.5
il s'acharnait aux	French	4.5
choses jusqu'à ce	French	4.5
qu'il les eût	French	4.5
comprises le rencontrait	French	4.5
souvent par les	French	4.5
champs la tête	French	4.5
nue les pieds	English	English
dans des sabots	English	English
et un livre	French	4.5
à la main	French	1.5
et il ne	French	4.5
le lâchait pas	French	4.5
qu'il ne se	French	2.5
le fût bien	French	4.5
mis dans la	French	4.5
tête seule chose	French	4.5
pouvait le détourner	French	4.5
de cette occupation	English	English
c'était le plaisir	English	English
qu'il goûtait à	French	2.5
voir son père	French	4.5
manier les vieilles	French	4.5
armes qu'on lui	French	4.5
apportait des quatre	French	0.5
coins de la	French	4.5
ville et des	French	4.5
châteaux du voisinage	English	English
pour les remettre	French	4.5
en état Guillaume	English	English
était le meilleur	French	4.5
arquebusier du canton	English	English
c'était un art	English	English
qu'il avait appris	French	2.5
au temps où	French	4.5
il était maître	French	4.5
de fauconnerie chez	French	4.5
M d'Assonville et	French	4.5
qui lui aurait	French	4.5
rapporté beaucoup d'argent	English	English
s'il avait voulu	French	1.5
l'exercer dans l'espoir	French	4.5
du gain dans	French	4.5
sa condition il	French	2.5
agissait en artiste	English	English
ne voulant pas	French	4.5
autre chose que	French	4.5
le juste salaire	French	1.5
de son travail	French	4.5
qu'il estimait toujours	French	4.5
moins qu'il ne	French	4.5
valait s'amusait souvent	French	4.5
à l'aider et	French	4.5
lorsqu'il avait fourbi	English	English
un haubert ou	French	4.5
quelque épée il	French	2.5
s'estimait le plus	French	4.5
heureux garçon du	French	4.5
pays pourvu toutefois	French	2.5
que de lui	French	4.5
donnât au point	English	English
du jour son	French	4.5
sourire quotidien se	French	2.5
promenait dans le	French	4.5
jardin du fauconnier	French	4.5
en compagnie des	French	4.5
enfants et des	French	4.5
animaux domestiques qui	French	4.5
vivaient par là	French	4.5
en bonne intelligence	English	English
elle offrait avec	French	2.5
le plus étrange	French	0.5
contraste qui se	French	2.5
pût voir était	French	4.5
grand fort vigoureux	French	0.5
yeux noirs pleins	English	English
de fermeté et	French	4.5
d'éclat brillaient sous	French	4.5
un front bruni	French	1.5
par le hâle	French	4.5
et tout chargé	French	4.5
d'épaisses boucles de	French	4.5
cheveux blonds moindre	French	4.5
geste de ses	French	4.5
bras on comprenait	French	4.5
qu'en un tour	French	2.5
de main il	French	2.5
aurait arraché un	French	4.5
jeune arbre ou	French	4.5
fait plier un	French	4.5
boeuf sur ses	French	4.5
jarrets mais au	French	4.5
moindre mot de	French	4.5
il rougissait au	French	4.5
contraire avait une	French	4.5
exquise délicatesse de	French	4.5
formes et de	French	4.5
traits à quinze	English	English
ans elle paraissait	French	4.5
en avoir douze	English	English
ou treize à	French	2.5
peine son visage	French	0.5
pâle sa taille	French	4.5
mince ses membres	French	4.5
frêles indiquaient une	French	4.5
organisation nerveuse d'une	French	4.5
finesse extrême pieds	English	English
et ses mains	French	4.5
appartenaient à l'enfance	French	1.5
le regard calme	English	English
et rayonnant de	French	4.5
ses grands yeux	French	4.5
bleus pleins de	French	4.5
vie et d'intelligence	French	0.5
les contours nets	English	English
et fermes de	French	4.5
sa bouche annonçaient	French	4.5
en même temps	French	2.5
la résolution d'une	French	4.5
âme honnête et	French	4.5
courageuse avait le	French	4.5
corps d'une enfant	English	English
et le sourire	French	4.5
d'une femme Lorsqu'il	French	4.5
lui arrivait de	French	4.5
s'endormir à l'ombre	French	1.5
d'un chêne la	French	4.5
tête appuyée sur	French	4.5
l'épaule de le	French	4.5
pauvre garçon restait	French	0.5
immobile tant que	French	4.5
durait le sommeil	French	4.5
de sa petite	English	English
amie et dans	French	4.5
une muette contemplation	English	English
il admirait le	French	4.5
jeune et pur	English	English
visage qui reposait	English	English
sur son coeur	English	English
avec un si	French	4.5
naïf abandon la	French	4.5
jeune fille entr'ouvrait	French	4.5
ses lèvres roses	English	English
et sérieuses retenait	English	English
son haleine pour	French	4.5
mieux entendre âme	French	4.5
oscillait à la	French	4.5
voix de comme	French	4.5
le rameau du	French	4.5
saule au moindre	French	4.5
souffle du vent	French	4.5
et parfois il	French	2.5
sentait en l'écoutant	French	4.5
monter à ses	French	4.5
paupières des larmes	French	0.5
dont la cause	English	English
lui était inconnue	French	0.5
mais dont la	French	4.5
source divine s'épanchait	French	0.5
dans son coeur	English	English
Un jour du	French	4.5
mois de mai	French	4.5
cinq ans avant	French	4.5
l'époque où commence	French	0.5
cette histoire et	French	4.5
peu de temps	French	2.5
avant la glorieuse	English	English
bataille des Jacques	English	English
qui pouvait avoir	French	4.5
alors treize ou	French	4.5
quatorze ans vit	French	0.5
venir à lui	French	4.5
tandis qu'il se	French	2.5
promenait dans une	French	4.5
prairie à une	French	4.5
petite distance de	French	4.5
un inconnu vêtu	French	4.5
d'assez méchants habits	English	English
aurait pu le	French	4.5
prendre pour quelque	French	4.5
déserteur à son	French	4.5
accoutrement qui tenait	French	4.5
autant du civil	English	English
que du militaire	French	4.5
si l'étranger n'avait	French	4.5
été contrefait ne	French	4.5
pouvait guère être	French	4.5
soldat avec une	French	4.5
bosse sur l'épaule	French	4.5
et pensa que	French	4.5
ce devait être	French	4.5
un colporteur suivait	French	4.5
un sentier tracé	French	0.5
par les maraîchers	French	4.5
entre les plants	English	English
de légumes et	French	4.5
se haussait parfois	French	1.5
sur un tertre	English	English
pour regarder pardessus	French	4.5
les haies dans	French	4.5
la campagne Quand	English	English
il fut proche	French	4.5
de il s'arrêta	French	4.5
et se mit	English	English
à le considérer	French	4.5
un instant était	French	4.5
appuyé contre un	French	4.5
gros pommier les	French	4.5
mains dans les	French	4.5
poches d'une blouse	English	English
en toile sifflant	French	1.5
entre ses dents	English	English
quelques minutes de	French	4.5
réflexion l'inconnu marcha	French	0.5
vers lui Estu	English	English
de ce pays	French	4.5
mon garçon lui	French	4.5
ditil Oui monsieur	French	4.5
répondit Si l'on	French	1.5
avait demandé à	French	2.5
pourquoi il avait	French	4.5
salué celui qu'il	French	4.5
prenait pour un	French	4.5
colporteur du nom	English	English
de monsieur il	French	2.5
aurait été fort	English	English
en peine de	French	4.5
l'expliquer avait un	French	4.5
air qui imposait	English	English
à bien que	French	4.5
le fils de	French	4.5
ne se laissât	French	4.5
point intimider facilement	French	0.5
parlait regardait et	French	4.5
agissait avec une	French	4.5
extrême simplicité mais	French	4.5
dans cette simplicité	French	4.5
il y avait	French	4.5
plus de noblesse	English	English
et de fierté	French	4.5
que dans toute	French	2.5
l'importance de de	French	4.5
S'il en est	French	4.5
ainsi reprit l'inconnu	French	0.5
tu pourras sans	French	4.5
doute m'indiquer quelqu'un	French	4.5
en état de	French	4.5
faire une longue	English	English
course à cheval	English	English
Vous avez ce	French	4.5
quelqu'unlà devant vous	French	4.5
monsieur Toi Moimême	French	4.5
Mais mon petit	English	English
ami tu me	French	4.5
parais bien jeune	French	4.5
qu'il s'agit de	French	4.5
faire au galop	English	English
sept ou huit	French	4.5
lieues sans débrider	French	0.5
Ne vous mettez	French	4.5
pas en peine	French	2.5
de l'âge fournissezmoi	French	4.5
seulement le cheval	English	English
et vous verrez	French	0.5
L'étranger sourit puis	French	4.5
il ajouta Il	French	2.5
est rétif et	French	4.5
plein de feu	French	4.5
J'ai bon bras	English	English
et bon oeil	French	2.5
il peut courir	French	4.5
Viens donc le	French	4.5
cheval n'est pas	French	4.5
loin L'inconnu et	French	4.5
quittèrent la prairie	English	English
et entrèrent dans	French	4.5
un petit bois	French	4.5
au milieu derrière	French	4.5
un fourré aperçut	French	1.5
un cheval qui	French	4.5
piaffait en tournant	English	English
autour d'un ormeau	French	2.5
auquel il était	French	4.5
attaché frein lié	French	4.5
sur ses naseaux	French	4.5
l'empêchait de hennir	French	1.5
n'avait jamais vu	French	4.5
un si bel	English	English
animal même dans	French	4.5
les écuries de	French	4.5
de Il s'approcha	French	1.5
du cheval lui	French	4.5
caressa la croupe	French	2.5
dénoua le frein	English	English
qui l'irritait et	French	4.5
s'apprêtait à sauter	French	1.5000000000000002
en selle quand	English	English
l'étranger lui mit	English	English
doucement la main	French	1.5
sur l'épaule Avant	French	4.5
de partir lui	French	4.5
ditil au moins	French	4.5
fautil que tu	English	English
saches où tu	English	English
dois aller C'est	French	4.5
juste répondit qui	French	4.5
avait déjà le	French	4.5
pied à l'étrier	French	4.5
L'impatience de galoper	English	English
sur un si	French	4.5
fier cheval lui	French	4.5
avait fait oublier	English	English
le but de	French	4.5
la course Tu	English	English
sais sans doute	French	4.5
où est le	French	4.5
petit village de	French	4.5
Très bien à	French	2.5
une lieue à	French	2.5
peu près sur	French	4.5
la droite du	French	4.5
côté d'Aire C'est	French	4.5
là que tu	English	English
vas te rendre	French	2.5
maintenant retiens bien	French	4.5
ceci avant d'entrer	French	4.5
à tu verras	English	English
sur la gauche	French	4.5
une ferme au	French	4.5
bout d'un champ	English	English
de seigle y	French	0.5
a quatre fenêtres	French	4.5
avec une girouette	French	1.5
en queue d'aronde	French	1.5
sur le toit	French	2.5
frapperas trois coups	English	English
à la porte	French	4.5
au troisième coup	English	English
tu prononceras à	French	2.5
haute voix le	French	4.5
nom de un	French	4.5
homme sortira et	French	4.5
tu lui remettras	French	1.5
ce papier En	French	4.5
achevant ces mots	English	English
l'inconnu tira de	French	4.5
sa poche un	French	4.5
petit portefeuille prit	French	0.5
un crayon et	French	4.5
se mit en	French	4.5
devoir d'écrire Saistu	French	1.5
lire demandatil brusquement	French	1.5
à Oui monsieur	French	4.5
très bien L'étranger	French	4.5
fronça le sourcil	French	0.5
mais ce mouvement	French	4.5
fut si rapide	French	4.5
que Jacques n'eut	English	English
pas le temps	French	2.5
de s'en apercevoir	French	0.5
instant l'étranger tourna	English	English
le crayon entre	French	4.5
ses doigts puis	French	4.5
prenant une résolution	French	4.5
subite il écrivit	French	4.5
rapidement quelques mots	English	English
déchira le feuillet	French	1.5
et le présentant	French	4.5
à attacha sur	French	4.5
l'enfant un regard	English	English
profond examina le	French	4.5
papier Je lis	English	English
mais je ne	French	4.5
comprends pas ditil	French	4.5
L'étranger sourit Il	French	2.5
n'est pas nécessaire	French	4.5
que tu comprennes	French	4.5
repritil mets le	French	4.5
papier dans ta	English	English
poche et saute	French	1.5
à cheval mon	French	4.5
garçon tu te	French	2.5
tiens gaillardement si	French	4.5
tu t'y prends	English	English
de cette façon	French	4.5
tu ne serviras	French	1.5
pas de fascine	English	English
à quelque fossé	French	4.5
aie toujours les	French	4.5
yeux sur les	French	4.5
oreilles de l'animal	English	English
il est fantasque	English	English
mais quand il	French	2.5
est en humeur	French	0.5
de faire un	French	4.5
écart il a	English	English
l'honnêteté d'en prévenir	French	4.5
son cavalier par	French	4.5
un certain mouvement	French	4.5
d'oreille dont les	French	4.5
reins de beaucoup	French	2.5
de gens ont	French	2.5
gardé le souvenir	French	4.5
tu ris tu	English	English
verras mon garçon	French	4.5
Comme lâchait la	French	4.5
bride au cheval	English	English
l'étranger le retint	English	English
Un mot encore	French	4.5
dans les environs	French	4.5
une maison de	French	4.5
braves gens où	French	4.5
je puisse attendre	French	4.5
ton retour sans	French	4.5
craindre les indiscrets	English	English
J'en connais dix	French	4.5
mais il y	French	0.5
en a une	French	4.5
surtout qui fera	French	0.5
votre affaire Sortez	French	4.5
du bois suivez	French	4.5
le sentier où	French	4.5
je vous ai	French	4.5
rencontré prenez la	French	4.5
grande route et	French	4.5
arrêtezvous devant la	French	4.5
première maison que	French	4.5
vous trouverez sur	French	4.5
votre droite la	French	4.5
reconnaîtrez facilement est	French	4.5
ouvert portes et	French	4.5
fenêtres serez chez	French	4.5
mon père Grinedal	English	English
comme chez vous	French	4.5
Diable mais j'y	French	4.5
serai très bien	French	4.5
dit l'étranger avec	French	2.5
un sourire maintenant	French	4.5
Il retira sa	French	4.5
main qui serrait	French	4.5
la gourmette et	French	4.5
le cheval partit	French	0.5
quart d'heure après	French	4.5
l'étranger entrait dans	French	4.5
le jardin de	French	4.5
Grinedal la vue	French	4.5
d'un étranger le	French	4.5
fauconnier quitta un	French	4.5
long pistolet d'arçon	French	4.5
qu'il fourbissait et	French	4.5
se leva Que	French	4.5
demandezvous lui ditil	French	4.5
L'hospitalité Entrez que	French	4.5
j'ai est à	French	2.5
vous vous avez	French	4.5
faim vous mangerez	French	4.5
si vous avez	French	4.5
soif vous boirez	French	4.5
et pour si	French	4.5
pauvre que je	French	4.5
sois j'ai toujours	French	4.5
un lit pour	French	4.5
le voyageur que	French	4.5
conduit En parlant	English	English
ainsi le père	French	4.5
avait découvert son	French	4.5
front ses traits	French	4.5
honnêtes ridés par	French	4.5
le travail gardaient	French	4.5
une expression de	French	4.5
dignité qui le	French	4.5
faisait paraître audessus	French	4.5
de sa condition	French	0.5
Je vous remercie	French	4.5
dit l'étranger ma	French	4.5
visite sera courte	English	English
votre fils sera	French	4.5
revenu je partirai	French	4.5
Guillaume l'interrogea du	French	4.5
regard Oh reprit	English	English
son hôte il	French	2.5
ne court aucun	French	2.5
danger que la	French	4.5
lune se soit	French	4.5
levée il sera	French	4.5
de retour suis	French	4.5
un marchand d'Arras	English	English
qui vais pour	French	4.5
les affaires de	French	4.5
mon commerce à	French	2.5
le pays est	French	4.5
mauvais et j'ai	French	4.5
pensé que votre	French	4.5
fils pourrait plus	French	4.5
sûrement que moi	French	4.5
se charger d'une	French	4.5
valise laissée aux	French	4.5
mains de mon	French	4.5
valet à ne	French	4.5
saurait trop prendre	French	4.5
de précautions dans	French	4.5
les temps où	French	4.5
nous vivons Tandis	English	English
que l'étranger parlait	French	1.5
et quelques enfants	English	English
d'abord épars dans	French	4.5
le jardin s'étaient	French	4.5
doucement rangés autour	French	4.5
de lui avec	French	2.5
cette avide et	French	4.5
farouche curiosité qui	French	4.5
cherche mille détours	French	4.5
pour se satisfaire	English	English
et s'étonne de	French	4.5
tout ce qu'elle	French	4.5
voit les écarta	French	4.5
du geste et	French	4.5
pria l'étranger de	French	4.5
le suivre à	French	2.5
quoi celuici se	French	2.5
soumit sans délibérer	French	4.5
Vous avez raison	French	4.5
reprit le fauconnier	French	4.5
quand ils furent	English	English
parvenus dans la	French	4.5
salle basse de	French	4.5
la maisonnette nous	French	4.5
vivons dans un	French	4.5
temps où il	French	2.5
faut s'entourer de	French	4.5
précautions dans la	French	4.5
maison d'un honnête	French	4.5
homme il n'en	French	4.5
est pas besoin	French	2.5
ainsi mon gentilhomme	French	4.5
ne vous gênez	French	4.5
point pour déguiser	French	0.5
votre langage et	French	4.5
vos manières A	English	English
ces mots l'étranger	French	4.5
tressaillit Je ne	French	4.5
vous demande pas	French	4.5
votre qualité et	French	4.5
votre nom reprit	English	English
le fauconnier est	French	4.5
sacré son secret	English	English
est comme sa	French	4.5
personne mais il	French	2.5
ne faut point	English	English
parler devant les	French	4.5
enfants les enfants	English	English
ont le sens	French	0.5
droit ils comprennent	French	4.5
et devinent sitôt	French	4.5
qu'on ouvre la	French	4.5
bouche ils écoutent	French	4.5
Se taire est	French	4.5
donc prudent j'ai	French	4.5
des cheveux gris	French	4.5
je n'ai rien	French	4.5
vu rien entendu	French	4.5
rien compris Vous	French	4.5
êtes un brave	English	English
homme s'écria impétueusement	French	4.5
l'étranger je n'ai	French	0.5
que faire de	French	4.5
dissimuler avec vous	French	4.5
ne vous êtes	French	4.5
pas trompé maître	French	4.5
je suis Plus	French	4.5
peutêtre que je	French	4.5
ne suppose se	French	2.5
hâta d'ajouter le	French	4.5
fauconnier et c'est	French	4.5
pourquoi je prends	English	English
la liberté de	French	4.5
vous interrompre afin	French	2.5
de n'en pas	French	4.5
savoir davantage vous	French	4.5
soyez ou vous	French	4.5
n'en êtes pas	French	4.5
moins un voyageur	French	1.5
remis à ma	French	4.5
garde toit vous	French	4.5
protège vous êtes	French	4.5
de ceux qui	French	4.5
ont tiré l'épée	French	4.5
contre leur roi	French	4.5
et leur pays	French	4.5
c'est à de	French	4.5
vous juger fais	French	4.5
mon devoir puissiezvous	French	4.5
dire fais le	French	4.5
mien Le faux	French	4.5
marchand baissa les	French	4.5
yeux sous le	French	4.5
regard serein de	French	4.5
l'artisan et la	French	4.5
rougeur passa sur	French	4.5
son front comme	French	4.5
un éclair reprenant	English	English
aussitôt sa sérénité	French	4.5
il salua de	French	4.5
la main le	French	4.5
vieux fauconnier Soit	French	4.5
mon brave je	French	4.5
ne chargerai pas	French	4.5
votre mémoire d'un	French	4.5
souvenir mais par	French	4.5
le nom de	French	4.5
mon père je	French	4.5
n'oublierai ni le	French	4.5
vôtre ni ce	French	4.5
que vous faites	French	4.5
Deux heures se	French	2.5
passèrent et l'étranger	French	4.5
partagea le dîner	French	4.5
du fauconnier à	French	2.5
l'aise comme sous	French	4.5
la tente d'un	French	4.5
soldat ou dans	French	4.5
l'hôtel d'un grand	English	English
seigneur deux autres	French	4.5
se passèrent encore	French	4.5
à la fin	English	English
de la quatrième	French	4.5
l'inquiétude rapprocha la	French	4.5
pointe de ses	French	4.5
sourcils marcha vers	English	English
la fenêtre et	French	4.5
l'ouvrit prêtant l'oreille	French	1.5
la nuit était	French	4.5
venue et la	French	4.5
route était sans	French	4.5
bruit il sortit	French	0.5
de la maisonnette	French	4.5
et s'avança vers	English	English
la porte du	French	4.5
jardin père le	French	4.5
suivit que l'obscurité	French	4.5
le silence était	French	4.5
profond Votre fils	English	English
est brave dit	French	1.5
l'étranger brusquement au	French	4.5
fauconnier Honnête et	French	4.5
brave comme l'acier	French	0.5
Il défendrait donc	French	4.5
un dépôt confié	French	4.5
à sa fidélité	French	4.5
Ce n'est qu'un	French	4.5
enfant mais il	French	2.5
se ferait tuer	English	English
comme un homme	French	4.5
Alors j'ai peur	French	4.5
pour votre fils	English	English
maître Le père	French	4.5
ne répondit pas	French	4.5
mais aux rayons	English	English
de la lune	French	4.5
l'étranger vit s'étendre	French	4.5
la pâleur sur	French	4.5
son front deux	French	4.5
gardèrent le silence	French	0.5
les yeux attachés	French	0.5
sur la ligne	French	4.5
blanche du chemin	English	English
qui se noyait	French	1.5
dans un horizon	English	English
vague et sans	French	4.5
bornes mystères de	French	4.5
la nuit emplissaient	French	4.5
l'espace de bruits	English	English
confus rapides incertains	French	0.5
s'appuyait sur les	French	4.5
bâtons d'une haie	French	4.5
à clairevoie on	English	English
entendait craquer le	French	4.5
bois sous l'effort	English	English
de ses mains	French	4.5
gentilhomme froissait les	French	4.5
revers de son	French	4.5
habit Rien rien	French	4.5
encore murmuraitil je	French	4.5
donnerais mille louis	French	0.5
pour entendre le	French	4.5
galop d'un cheval	English	English
Comme il parlait	French	1.5
une détonation retentit	English	English
dans l'éloignement plus	French	4.5
loin que le	French	4.5
bois dont les	French	4.5
ombres épaisses coupaient	French	4.5
l'horizon haie se	French	2.5
brisa sous la	French	4.5
main du fauconnier	French	4.5
qui sauta sur	French	4.5
la route Un	French	4.5
coup de fusil	English	English
entendu s'écria le	French	4.5
gentilhomme Je l'ai	French	4.5
entendu répondit qui	French	4.5
se jeta à	French	2.5
plat ventre sur	French	4.5
le chemin Deux	French	4.5
autres détonations retentirent	English	English
encore mais le	French	4.5
son venait de	French	4.5
si loin qu'il	French	4.5
fallait l'oreille d'un	French	4.5
père ou d'un	French	4.5
proscrit pour les	French	4.5
distinguer des mille	French	4.5
bruits qui flottaient	English	English
sous le ciel	French	4.5
profond Guillaume écoutait	French	4.5
l'oreille collée à	French	2.5
la terre Eh	French	2.5
bien dit le	French	4.5
gentilhomme Rien rien	French	4.5
encore coeur me	French	4.5
bat et les	French	4.5
oreilles me tintent	English	English
dit le pauvre	French	4.5
père oui maintenant	French	4.5
un bruit sourd	French	2.5
saccadé continu Il	French	2.5
approche c'est le	French	4.5
galop d'un cheval	English	English
Oh le brave	English	English
enfant s'écria l'étranger	French	4.5
avec explosion Guillaume	English	English
ne dit rien	French	4.5
mais découvrant son	French	4.5
front blanchi par	French	4.5
les années il	French	2.5
leva les yeux	French	4.5
vers le ciel	French	4.5
et pria gentilhomme	French	4.5
regardait dans l'espace	French	0.5
la tête penchée	French	4.5
en avant on	English	English
aurait dit que	French	4.5
ses yeux étincelants	French	0.5
voulaient percer la	French	4.5
ténébreuse transparence de	French	4.5
la nuit Je	French	4.5
le vois mordieu	French	4.5
je le vois	French	4.5
cheval a des	French	4.5
ailes et l'enfant	English	English
est dessus Le	French	4.5
gentilhomme saisit le	French	4.5
bras du fauconnier	French	4.5
Ne le reconnaissezvous	French	4.5
pas ditil Mais	French	4.5
le fauconnier remerciait	French	0.5
deux grosses larmes	French	0.5
tremblaient au bord	English	English
de ses paupières	French	4.5
et ses lèvres	French	4.5
agitées murmuraient une	French	4.5
action de grâces	French	4.5
retira sa main	French	1.5
et plein d'une	French	4.5
religieuse émotion souleva	French	4.5
son chapeau quelques	French	4.5
bonds le cheval	English	English
arriva sur eux	French	4.5
L'enfant sauta sur	French	4.5
la route et	French	4.5
tomba dans les	French	4.5
bras du fauconnier	French	4.5
Mon père s'écriatil	French	4.5
Le père silencieux	French	0.5
le pressait sur	French	4.5
son coeur Mais	French	4.5
dit tout à	French	2.5
coup il y	French	0.5
a du sang	English	English
sur tes habits	English	English
blessé Ce n'est	French	4.5
rien répondit une	French	4.5
balle a déchiré	French	4.5
ma blouse là	French	4.5
près de l'épaule	French	4.5
et m'a égratigné	French	4.5
je crois Tu	English	English
es un vaillant	French	0.5
garçon sur ma	French	4.5
foi dit le	French	4.5
gentilhomme si jamais	French	1.5
tu t'enrôles sous	French	4.5
les drapeaux de	French	4.5
le roi vrai	French	4.5
tu feras ton	English	English
chemin voyons astu	English	English
la valise La	French	4.5
voilà sur la	French	4.5
croupe du cheval	English	English
Pauvre l'as rudement	French	1.5
mené hein dit	French	1.5
gaiement l'étranger en	French	4.5
passant la main	French	1.5
sur le cou	French	1.5
du cheval Phoebus	English	English
frotta ses naseaux	French	4.5
écumants sur l'habit	French	0.5
du gentilhomme dressa	French	0.5
l'oreille à la	French	4.5
voix du maître	French	4.5
hennit et frappa	English	English
du pied le	French	4.5
sol Tu as	English	English
donc été poursuivi	French	4.5
reprit l'étranger tout	French	2.5
en débouclant la	French	4.5
valise A une	French	4.5
petite lieue de	French	4.5
j'ai dû quitter	English	English
le grand chemin	English	English
pour éviter un	French	4.5
parti de maraudeurs	French	4.5
espagnols répondit lieues	French	4.5
plus loin en	French	4.5
avant de près	French	4.5
de je suis	French	4.5
tombé au milieu	French	4.5
d'une bande de	French	4.5
hussards et d'impériaux	French	4.5
qui battaient l'estrade	English	English
Ils m'ont poussé	French	4.5
vivement durant un	French	4.5
quart d'heure a	English	English
de bonnes jambes	English	English
l'entrée du bois	French	4.5
ils ont perdu	French	0.5
mes traces j'oubliais	French	1.5
m'a chargé d'une	French	4.5
lettre pour vous	French	4.5
voici Le gentilhomme	French	4.5
brisa le cachet	English	English
et s'approchant de	French	4.5
la fenêtre il	French	2.5
lut rapidement à	French	2.5
la clarté d'une	French	4.5
lampe C'est bien	French	4.5
mon enfant quelque	French	4.5
jour nous nous	French	4.5
rencontrons moi vieillard	English	English
toi homme dans	French	4.5
quelque situation que	French	4.5
nous nous trouvions	French	4.5
l'un et l'autre	French	4.5
tu pourras en	French	4.5
appeler à l'hôte	French	4.5
de il se	French	2.5
souviendra Au point	English	English
du jour l'étranger	French	4.5
sauta sur la	French	4.5
selle de qui	French	4.5
avait oublié entre	French	4.5
une litière fraîche	French	4.5
et deux boisseaux	French	4.5
d'avoine les fatigues	French	1.5
de la soirée	French	4.5
portait un costume	English	English
de paysan de	French	4.5
l'Artois Adieu ditil	French	4.5
au fauconnier en	French	4.5
lui tendant la	French	4.5
main je ne	French	4.5
vous offre rien	French	4.5
votre hospitalité est	French	4.5
de celles qui	French	4.5
ne se payent	French	0.5
pas et je	French	4.5
craindrais de vous	French	4.5
offenser en vous	French	4.5
donnant de l'or	French	1.5
ma main et	French	4.5
serrezla sans crainte	French	4.5
quelque habit que	French	4.5
je me cache	English	English
c'est je vous	French	4.5
le jure la	French	4.5
main d'un loyal	English	English
gentilhomme à toi	French	4.5
mon ami conserve	French	0.5
ce coeur honnête	French	4.5
et ce courage	English	English
déterminé et la	French	4.5
fortune te viendra	French	4.5
en aide si	French	4.5
me prête vie	French	4.5
je le prierai	French	4.5
pour qu'il me	French	4.5
fournisse l'occasion de	French	4.5
te secourir comme	French	4.5
tu m'as secouru	French	0.5
Les grands yeux	French	4.5
noirs de regardaient	English	English
l'étranger tout brillants	English	English
d'une joie fière	French	4.5
son épaule difforme	French	4.5
et sa poitrine	English	English
contrefaite le faux	French	4.5
marchand d'Arras lui	French	4.5
semblait plus noble	English	English
et plus imposant	English	English
que tous les	French	4.5
officiers du roi	French	4.5
qu'il avait encore	French	4.5
vus il lui	French	4.5
prit la main	French	1.5
le coeur de	French	4.5
battit à coups	English	English
rapides et lorsque	French	4.5
pressant les flancs	English	English
de l'inconnu s'éloigna	French	4.5
au galop longtemps	English	English
le père et	French	4.5
le fils le	French	4.5
suivirent du regard	English	English
émus et silencieux	French	0.5
moment où ils	French	2.5
rentraient au jardin	French	0.5
le pied de	French	4.5
fit rouler un	French	4.5
objet brillant tombé	French	1.5
sur le sable	French	4.5
un médaillon en	French	4.5
or guilloché Voyez	French	4.5
mon père dit	French	1.5
l'enfant l'étranger l'aura	French	4.5
sans doute perdu	French	0.5
Gardele mon fils	English	English
c'est peutêtre la	French	4.5
qui te l'envoie	French	4.5
II LES Le	French	4.5
souvenir de cette	French	4.5
aventure resta dans	French	4.5
la mémoire de	French	4.5
temps put en	French	4.5
affaiblir les détails	French	4.5
mais l'ensemble demeura	French	4.5
comme un point	English	English
lumineux au fond	French	2.5
de son coeur	English	English
le jour de	French	4.5
sa rencontre avec	French	2.5
l'étranger il prit	French	0.5
un goût plus	French	4.5
vif aux choses	French	0.5
de la guerre	English	English
escadron passait sur	French	4.5
la route bannière	French	4.5
au vent et	French	4.5
trompette en tête	French	4.5
il courait à	French	2.5
sa suite aussi	French	4.5
loin que ses	French	4.5
jambes le pouvaient	French	4.5
porter et fredonnait	English	English
les fanfares pendant	French	4.5
toute une semaine	French	4.5
aussi il lui	French	4.5
arrivait d'enrégimenter les	French	4.5
enfants du faubourg	English	English
et de se	French	2.5
livrer avec eux	French	4.5
à un grand	English	English
simulacre de bataille	French	4.5
ou à quelque	French	4.5
imitation de siège	French	4.5
qui finissait toujours	French	4.5
par de furieuses	French	4.5
mêlées où ses	French	4.5
bras faisaient merveille	French	2.5
tout enfant qu'il	French	4.5
était il se	French	2.5
montrait déjà d'une	French	4.5
adresse surprenante dans	French	4.5
le maniement des	French	4.5
armes épée sabre	French	1.5
hache pique dague	English	English
pistolet ou mousqueton	English	English
mots du marchand	English	English
d'Arras jamais tu	English	English
t'enrôles tu feras	English	English
ton chemin bourdonnaient	French	4.5
toujours à ses	French	4.5
oreilles mais nous	French	4.5
devons ajouter qu'il	French	4.5
n'y avait pas	French	4.5
d'exercice de revue	French	4.5
de combat et	French	4.5
d'assaut que n'abandonnât	English	English
volontiers pour suivre	French	4.5
de quand elle	French	4.5
allait avec chercher	French	2.5
des fraises dans	French	4.5
les bois ces	French	4.5
occasions qui se	French	2.5
renouvelaient tous les	French	4.5
jours le petit	English	English
général soupirait de	French	4.5
tout son coeur	English	English
et demeurait tout	French	2.5
interdit lorsque la	French	4.5
main de rencontrait	French	4.5
sa main petite	English	English
fille le faisait	French	4.5
aller et venir	French	4.5
à son gré	French	4.5
mais avec tant	French	2.5
de grâce naturelle	French	4.5
et d'un air	French	0.5
si charmant que	French	4.5
serait parti pour	French	4.5
le bout du	French	4.5
monde sans délibérer	French	4.5
sur un signe	French	4.5
de ses yeux	French	4.5
bleus Les années	French	4.5
se passaient donc	French	4.5
entre les études	French	4.5
les batailles et	French	4.5
les promenades était	French	4.5
en ce tempslà	French	4.5
au milieu des	French	4.5
troubles et des	French	4.5
guerres on n'entendait	French	4.5
parler que de	French	4.5
villes attaquées de	French	4.5
camps surpris d'expéditions	French	4.5
meurtrières cardinal et	French	4.5
le parti du	French	4.5
roi luttaient contre	French	4.5
le parlement les	French	4.5
princes et l'Espagnol	English	English
de tenait la	French	4.5
campagne tantôt vainqueur	French	4.5
tantôt vaincu mais	French	4.5
jusqu'alors la ville	French	0.5
de protégée par	French	4.5
une bonne garnison	French	1.5
n'avait pas eu	French	0.5
à souffrir des	French	4.5
déprédations de l'ennemi	English	English
serait parti depuis	French	4.5
longtemps s'il n'avait	French	4.5
été retenu par	French	4.5
le charme qu'il	French	4.5
éprouvait à vivre	French	4.5
auprès de de	French	4.5
sentiment était d'autant	French	4.5
plus impérieux qu'il	French	4.5
ne s'en rendait	French	4.5
pas compte hasard	English	English
ce grand architecte	English	English
de l'avenir lui	French	4.5
fit lire dans	French	4.5
son propre coeur	English	English
Un jour qu'il	French	4.5
était assis dans	French	4.5
un coin du	French	4.5
jardin la tête	French	4.5
penchée et roulant	English	English
une dague entre	French	4.5
ses doigts sa	French	4.5
soeur vint tout	French	2.5
doucement lui frapper	English	English
sur l'épaule tressaillit	French	0.5
A quoi pensestu	English	English
dit l'espiègle Je	French	4.5
n'en sais rien	French	4.5
Veuxtu que je	French	4.5
te le dise	English	English
moi penses à	French	2.5
mamzelle Pourquoi à	French	2.5
elle plutôt qu'à	French	4.5
une autre s'écria	French	4.5
un peu confus	English	English
Parce que est	French	4.5
Belle raison Très	French	4.5
bonne reprit l'enfant	English	English
dont un malin	English	English
sourire entr'ouvrit les	French	4.5
lèvres vermeilles je	French	4.5
me comprends Alors	French	2.5
expliquetoi Tiens ajouta	French	1.5
en prenant un	French	4.5
grand air sérieux	French	4.5
tu penses à	French	2.5
mamzelle parce que	French	4.5
tu l'aimes Jacques	English	English
rougit jusqu'à la	French	4.5
racine des cheveux	French	4.5
il se dressa	French	0.5
d'un bond un	French	4.5
trouble nouveau remplissait	French	4.5
son âme et	French	4.5
mille sensations confuses	English	English
l'animaient avait lui	French	4.5
dans sa pensée	French	4.5
il saisit par	French	4.5
le bras Mon	French	4.5
qu'astu donc s'écria	French	4.5
effrayée du brusque	French	1.5
changement qui s'était	French	4.5
opéré dans les	French	4.5
traits de son	French	4.5
frère Écoutemoi ma	French	4.5
soeur tu n'es	French	4.5
qu'une petite fille	English	English
J'aurai quinze ans	English	English
viennent les abricots	English	English
dit l'enfant Mais	French	4.5
continua on dit	French	1.5
que les petites	English	English
filles s'entendent mieux	French	4.5
à ces choseslà	French	4.5
que les grands	English	English
garçons m'astu dit	French	1.5
que j'aimais mamzelle	French	2.5
se peut mais	French	4.5
je n'en sais	French	4.5
rien Dame on	English	English
voit ça du	French	4.5
premier coup d'oeil	English	English
comment je ne	French	4.5
le pourrais guère	French	4.5
mais je l'ai	French	4.5
compris à plusieurs	French	4.5
choses que je	French	4.5
ne puis pas	French	4.5
t'expliquer parce que	French	4.5
je ne sais	French	4.5
par quel bout	English	English
les prendre D'abord	English	English
tu ne lui	French	4.5
parles pas comme	French	4.5
aux autres filles	English	English
que tu connais	French	4.5
et puis tu	English	English
as les yeux	French	4.5
doux comme du	French	4.5
miel quand tu	English	English
la regardes tu	English	English
fais de grands	English	English
tours pour l'éviter	French	4.5
et cependant tu	English	English
la rencontres toujours	French	4.5
ou bien tu	English	English
la cherches partout	French	4.5
et quand tu	English	English
la trouves tu	English	English
t'arrêtes tout court	English	English
et l'on dirait	French	4.5
que tu as	English	English
envie de te	French	2.5
cacher je ne	French	4.5
sais ni pourquoi	French	4.5
ni comment mais	French	4.5
tu l'aimes C'est	French	4.5
vrai murmura en	French	4.5
lâchant le bras	English	English
de sa soeur	English	English
c'est vrai je	French	4.5
l'aime Sa voix	French	4.5
en prononçant ces	French	4.5
mots si doux	French	4.5
au coeur avait	French	4.5
quelque chose de	French	4.5
grave et de	French	4.5
triste qui émut	French	1.5
Eh bien ditelle	French	4.5
en passant ses	French	4.5
jolis bras autour	French	4.5
du cou de	French	4.5
son frère ne	French	4.5
vastu pas t'affliger	English	English
maintenant donc une	French	4.5
chose si pénible	French	4.5
d'aimer les gens	English	English
qu'il faille prendre	French	4.5
cet air malheureux	French	4.5
que tu me	French	4.5
fais pleurer à	French	2.5
présent La pauvre	French	4.5
essuya le coin	English	English
de ses yeux	French	4.5
avec son tablier	English	English
puis souriant avec	French	2.5
la mobilité de	French	4.5
l'enfance elle se	French	2.5
haussa sur la	French	4.5
pointe du pied	English	English
et approchant sa	French	4.5
bouche de l'oreille	French	1.5
de elle reprit	English	English
Bah à ta	English	English
place moi je	French	4.5
me réjouirais n'est	French	4.5
pas ta soeur	English	English
je suis sûre	French	4.5
qu'elle t'aime autant	French	0.5
que tu l'aimes	French	0.5
tu l'épouseras Jacques	English	English
embrassa sur les	French	4.5
deux joues Tu	English	English
es une bonne	French	4.5
soeur lui ditil	French	4.5
va maintenant je	French	4.5
sais ce que	French	4.5
l'honnêteté me commande	French	4.5
Et se dégageant	French	4.5
de l'étreinte de	French	4.5
sa soeur sortit	French	0.5
du jardin Il	French	2.5
se rendait tout	French	2.5
droit au château	French	4.5
lorsqu'au détour d'une	French	4.5
haie il rencontra	French	0.5
de Je vous	French	4.5
cherchais monsieur lui	French	4.5
ditil en le	French	4.5
saluant Moi qu'astu	French	1.5
à me dire	French	4.5
mon garçon J'ai	French	4.5
à vous parler	French	4.5
d'une affaire très	French	4.5
importante En vérité	French	4.5
bien parle je	French	4.5
t'écoute Monsieur j'ai	French	4.5
aujourd'hui dixhuit ans	English	English
et quelques mois	French	4.5
reprit Jacques de	French	4.5
l'air grave d'un	French	4.5
ambassadeur je suis	French	4.5
un honnête garçon	French	4.5
qui ai de	French	4.5
bons bras et	French	4.5
un peu d'instruction	French	1.5
j'aurai un jour	French	4.5
deux ou trois	French	4.5
mille livres d'un	French	4.5
oncle qui est	French	4.5
curé en car	French	2.5
pour le bien	French	4.5
qui peut me	French	4.5
revenir du côté	French	4.5
de mon père	French	4.5
je suis décidé	French	4.5
à le laisser	French	4.5
à ma soeur	English	English
cet état je	French	4.5
viens vous demander	English	English
si vous voulez	French	4.5
bien me donner	French	4.5
votre fille en	French	4.5
mariage En mariage	English	English
à toi que	French	4.5
tu me dis	French	1.5000000000000002
donc s'écria de	French	4.5
Malzonvilliers tout étourdi	French	4.5
Je dis monsieur	French	4.5
que j'aime le	French	4.5
respect que je	French	4.5
vous dois et	French	4.5
mon devoir ne	French	4.5
me permettent pas	French	4.5
de l'en informer	English	English
avant de vous	French	4.5
avoir parlé de	French	4.5
mes sentiments pourquoi	French	4.5
je viens vous	French	4.5
prier de m'agréer	French	4.5
pour votre gendre	French	4.5
Pendant ce discours	English	English
le chapeau à	French	2.5
la main un	French	4.5
mouchoir roulé autour	French	4.5
du cou et	French	4.5
en sarrau de	French	4.5
toile grise était	French	4.5
debout au beau	French	2.5
milieu du sentier	French	0.5
Je n'ai pas	French	4.5
besoin de vous	French	4.5
dire ajoutatil que	French	4.5
votre consentement me	French	4.5
rendra parfaitement heureux	French	4.5
et que je	French	4.5
n'aurai plus d'autre	French	4.5
désir que de	French	4.5
reconnaître toutes vos	French	4.5
bontés par ma	French	4.5
conduite et mon	French	4.5
dévouement Tout à	French	2.5
coup de partit	French	0.5
d'un grand éclat	French	4.5
de rire L'étrangeté	French	4.5
de la proposition	French	4.5
et le sangfroid	English	English
avec lequel elle	French	4.5
était faite l'avaient	French	4.5
d'abord étourdi mais	French	4.5
au nouveau discours	English	English
de il ne	French	4.5
put s'empêcher de	French	4.5
rire au nez	French	4.5
du pauvre garçon	French	4.5
le sang de	French	4.5
lui monta au	French	4.5
visage les illusions	French	0.5
dont se berce	English	English
la jeunesse son	French	4.5
bon sens natif	French	2.5
lui disait tout	French	2.5
bas que sa	French	4.5
demande ne serait	French	4.5
point accueillie mais	French	4.5
sa candide honnêteté	French	4.5
ne lui permettait	French	4.5
pas de croire	French	4.5
qu'elle pût donner	French	4.5
matière à plaisanter	French	4.5
Ma proposition vous	French	4.5
a mis en	French	4.5
gaieté monsieur repritil	French	2.5
avec une émotion	French	0.5
mal contenue ne	French	4.5
m'attendais pas je	French	4.5
l'avoue à l'honneur	French	4.5
de vous causer	English	English
tant de joie	French	4.5
Eh mon ami	English	English
je ne m'attendais	French	4.5
pas non plus	French	4.5
à une telle	French	2.5
aventure Viton jamais	French	1.5
chose pareille plus	French	4.5
amusant qu'une comédie	French	4.5
de Corneille parole	English	English
d'honneur Jacques déchira	French	4.5
les bords de	French	4.5
son chapeau avec	French	2.5
ses doigts mais	French	4.5
il se tut	English	English
de riait toujours	French	4.5
n'y tenant plus	French	4.5
il s'assit sur	French	4.5
un quartier de	French	4.5
pierre au revers	English	English
du sentier Vous	French	4.5
aurez tout le	French	4.5
loisir de rire	French	4.5
après reprit mais	French	4.5
c'est à présent	French	4.5
le moment de	French	4.5
me répondre vous	French	4.5
ne sauriez deviner	English	English
monsieur ce qui	French	4.5
se passe dans	French	4.5
mon coeur depuis	French	4.5
que je sais	French	4.5
que j'aime J'attends	French	0.5
Ah çà mon	French	4.5
garçon estu fou	French	1.5
répondit le traitant	French	4.5
en s'essuyant les	French	4.5
yeux Un fou	French	1.5
ne vient pas	French	4.5
honnêtement demander la	French	4.5
main d'une jeune	French	4.5
personne à son	French	4.5
père C'est donc	French	4.5
sérieusement que tu	English	English
parles Très sérieusement	French	4.5
Taistoi et surtout	French	2.5
ne me regarde	English	English
pas avec cet	French	4.5
air de berger	English	English
malheureux ou tu	English	English
vas me faire	French	4.5
rire à m'étouffer	French	0.5
et je te	French	2.5
préviens que ce	French	4.5
serait abuser de	French	4.5
ma position je	French	4.5
suis très fatigué	French	4.5
mon ami Aussi	French	4.5
n'estce point mon	French	4.5
intention je désire	French	4.5
seulement savoir quels	French	4.5
sont vos sentiments	English	English
Vat'en au diable	English	English
avec mes sentiments	English	English
donc le temps	French	2.5
de m'amuser aux	French	4.5
sornettes qui trottent	English	English
par la tête	French	4.5
d'un maître fou	French	1.5
donc la belle	English	English
alliance la fille	English	English
de avec le	French	4.5
fils de Grinedal	English	English
le fauconnier Raillezvous	French	4.5
de moi tant	French	2.5
qu'il vous plaira	French	4.5
monsieur je ne	French	4.5
m'en offenserai pas	French	4.5
s'écria vivement mais	French	4.5
gardezvous de toucher	English	English
au nom de	French	4.5
mon père car	French	2.5
aussi bien qu'il	French	4.5
y a un	French	4.5
au ciel si	French	4.5
quelqu'un l'insultait fûtce	French	4.5
le père de	French	4.5
je me vengerais	French	4.5
Et que feraistu	French	1.5
drôle Je l'étranglerais	French	4.5
Et leva audessus	French	4.5
de sa tête	French	4.5
deux mains de	French	4.5
force à joindre	English	English
lestement l'effet à	French	2.5
la menace de	French	4.5
se dressa brusquement	French	1.5
et porta la	French	4.5
main à son	French	4.5
cou il lui	French	4.5
semblait sentir déjà	French	4.5
les doigts de	French	4.5
se nouer derrière	French	4.5
sa nuque abaissa	French	1.5
subitement ses bras	English	English
et de sa	French	4.5
violente émotion il	French	2.5
ne lui resta	English	English
qu'une grande pâleur	French	4.5
sur le visage	French	0.5
Je vous demande	French	4.5
pardon de mon	French	4.5
emportement repritil jamais	French	1.5
je n'aurais dû	French	4.5
oublier les bienfaits	French	4.5
dont vous avez	French	4.5
comblé ma famille	English	English
cette colère est	French	4.5
la faute de	French	4.5
ma jeunesse et	French	4.5
non de mon	French	4.5
coeur oubliezla monsieur	French	4.5
ne m'en voudriez	French	4.5
peutêtre pas si	French	4.5
vous saviez combien	French	1.5
je souffre depuis	French	4.5
que j'aime ne	French	4.5
vis que pour	French	4.5
Suzanne et je	French	4.5
sens bien que	French	4.5
je ne puis	French	4.5
pas l'obtenir si	French	4.5
pour la mériter	French	4.5
il me fallait	English	English
entreprendre quelque chose	French	4.5
d'impossible diteslemoi et	French	4.5
avec l'aide de	French	4.5
il me semble	French	4.5
que j'y parviendrais	French	4.5
monsieur que fautil	French	4.5
que je tente	French	4.5
que ce soit	French	4.5
je suis prêt	French	4.5
à obéir et	French	4.5
si je ne	French	4.5
réussis pas j'y	French	4.5
laisserai mon corps	English	English
Il y a	English	English
toujours dans l'expression	French	1.5
d'un sentiment vrai	French	4.5
un accent qui	French	4.5
émeut les larmes	French	0.5
étaient venues aux	French	4.5
yeux de et	French	4.5
son attitude exprimait	French	4.5
à la fois	French	4.5
l'angoisse et la	French	4.5
résignation de était	French	4.5
au fond un	French	4.5
bon homme la	French	4.5
vanité avait obscurci	French	0.5
son jugement sans	French	4.5
gâter son coeur	English	English
il se sentit	French	0.5
touché et tendit	English	English
la main à	French	2.5
Il ne faut	French	4.5
point te désoler	French	4.5
mon ami lui	French	4.5
ditil ni prendre	French	4.5
les choses avec	French	2.5
cette vivacité aimes	French	0.5
distu n'y a	English	English
pas si longtemps	English	English
que j'aimais encore	French	4.5
mais je ne	French	4.5
me souviens guère	French	4.5
de ce que	French	4.5
j'aimais à dixhuit	French	2.5
ans oublieras comme	French	4.5
j'ai oublié et	French	4.5
tu ne t'en	English	English
porteras pas plus	French	4.5
mal Jacques secoua	English	English
la tête tristement	French	0.5
Oui oui on	English	English
dit toujours comme	French	4.5
ça continua le	French	4.5
traitant mon Dieu	French	4.5
à ton âge	French	4.5
je me croyais	French	1.5
déjà dans la	French	4.5
rivière parce que	French	4.5
j'avais perdu l'objet	French	4.5
de ma première	French	4.5
flamme bah j'en	French	4.5
ai perdu bien	French	4.5
d'autres depuis raison	French	4.5
mon garçon tu	English	English
m'entendras car tu	English	English
as du bon	English	English
sens gentilshommes du	French	4.5
pays me demandent	English	English
la main de	French	4.5
Suzanne en conscience	English	English
te préférer toi	French	4.5
qui n'as rien	French	4.5
ni état ni	French	4.5
fortune et les	French	4.5
repousser eux qui	French	4.5
ont tout cela	French	4.5
Jacques baissa la	French	4.5
tête et une	French	4.5
larme tomba sur	French	4.5
la poussière du	French	4.5
sentier Parbleu si	French	4.5
tu étais riche	English	English
et noble reprit	English	English
de je ne	French	4.5
voudrais pas d'autre	French	4.5
gendre que toi	French	4.5
Si j'étais riche	English	English
et noble s'écria	French	4.5
Oui vraiment Eh	French	2.5
bien monsieur je	French	4.5
m'efforcerai de gagner	French	4.5
fortune et noblesse	English	English
Écoute donc mon	French	4.5
ami ces choseslà	French	4.5
ne viennent pas	French	4.5
très vite ne	French	4.5
te promets pas	French	4.5
d'attendre Jacques hésita	French	4.5
un instant puis	French	4.5
levant les yeux	French	4.5
au ciel il	French	2.5
reprit A la	French	4.5
garde de monsieur	French	4.5
je me presserai	French	4.5
le plus que	French	4.5
je pourrai Pauvre	French	4.5
garçon murmura de	French	4.5
tandis que s'éloignait	French	4.5
c'est vraiment dommage	French	0.5
qu'il ne soit	French	4.5
pas marquis ou	French	4.5
tout au moins	French	4.5
millionnaire Jacques se	French	2.5
dirigea d'un pas	French	4.5
lent mais ferme	French	2.5
vers un côté	French	4.5
du parc de	French	4.5
où avait coutume	English	English
de se promener	English	English
à cette heurelà	French	4.5
un livre ou	French	4.5
quelque ouvrage d'aiguille	English	English
à la main	French	1.5
l'aborda résolument et	French	4.5
lui raconta l'entretien	French	0.5
qu'il venait d'avoir	French	4.5
avec son père	French	4.5
sa voix était	French	4.5
tremblante mais son	French	4.5
regard assuré s'était	French	4.5
sentie rougir au	French	4.5
premier mot de	French	4.5
mais bientôt remise	English	English
de son trouble	English	English
elle avait attaché	French	0.5
sur son jeune	French	4.5
amant ce regard	English	English
clair et serein	English	English
qui rayonnait comme	French	4.5
une étoile au	French	4.5
fond de ses	French	4.5
yeux bleus Votre	French	4.5
père ne m'a	French	4.5
point laissé d'espérance	French	4.5
mademoiselle dit après	French	4.5
qu'il eut terminé	French	0.5
son récit cependant	French	4.5
je suis déterminé	French	4.5
à tout entreprendre	French	4.5
pour vous mériter	French	4.5
le permettezvous M'aimezvous	French	4.5
reprit la jeune	French	4.5
fille de cette	French	4.5
voix vibrante et	French	4.5
douce qui sonnait	French	4.5
comme le cristal	English	English
Si je vous	French	4.5
aime donnerais ma	French	4.5
vie pour ma	French	4.5
soeur mais mademoiselle	English	English
il me semble	French	4.5
et que me	French	4.5
pardonne ce blasphème	French	1.5
que je donnerais	French	4.5
le salut de	French	4.5
mon âme pour	French	4.5
vous Je serai	French	4.5
donc votre femme	French	4.5
un jour mon	French	4.5
ami reprit en	French	4.5
tendant sa main	French	1.5
à qui sentit	French	0.5
son coeur se	French	2.5
fondre à ces	French	4.5
mots sommes bien	French	4.5
jeunes tous deux	French	4.5
presque deux enfants	English	English
ajoutatelle avec un	French	4.5
sourire mais nous	French	4.5
viendra en aide	French	4.5
J'ai le coeur	English	English
fort s'écria ô	French	2.5
mademoiselle je vous	French	4.5
gagnerai J'y compte	French	4.5
et moi je	French	4.5
vous promets de	French	4.5
n'être jamais qu'à	French	4.5
vous Jacques voulut	French	4.5
baiser la main	French	1.5
de mais lui	French	4.5
ouvrit ses bras	English	English
et les deux	French	4.5
enfants s'embrassèrent deux	French	4.5
étaient à la	French	4.5
fois graves et	French	4.5
ingénus croyaient à	French	2.5
leur coeur Allez	French	0.5
et méritezmoi reprit	English	English
les joues humides	English	English
et rougissantes moi	French	4.5
je vous attendrai	French	4.5
en priant Ils	French	2.5
échangèrent un dernier	French	4.5
serment et se	French	2.5
séparèrent Jacques reprit	English	English
le chemin de	French	4.5
la maisonnette sérieux	French	4.5
mais non plus	French	4.5
triste fit tout	French	2.5
de suite part	French	0.5
à de ce	French	4.5
qui s'était passé	French	4.5
dans la journée	French	4.5
Nous nous aimons	English	English
ajoutatil et nous	French	4.5
nous marierons Le	French	4.5
père regarda les	French	4.5
hirondelles qui fuyaient	French	2.5
au loin dans	French	4.5
le ciel bleu	French	0.5
Serments d'amoureux ditil	French	4.5
en hochant sa	French	4.5
tête chauve qu'ils	French	4.5
durent ou qu'ils	French	4.5
passent il n'importe	French	4.5
mon fils il	French	2.5
faut partir C'était	French	4.5
mon intention répondit	French	4.5
Le père et	French	4.5
le fils se	French	2.5
serrèrent la main	French	1.5
La fille appartient	English	English
au père reprit	English	English
de Malzonvilliers a	English	English
été bon pour	French	4.5
nous il ne	French	4.5
faut pas qu'il	French	4.5
t'accuse d'avoir voulu	French	1.5
semer le désordre	French	4.5
dans sa maison	French	4.5
partiras demain sans	French	4.5
chercher à revoir	French	4.5
Jacques hésita Il	French	2.5
le faut répéta	French	4.5
le vieillard Je	French	4.5
partirai dit le	French	4.5
fils je partirai	French	4.5
sans la revoir	French	4.5
Vers le soir	French	4.5
à l'heure accoutumée	French	0.5
on s'assit autour	French	4.5
de la table	English	English
Le dîner fut	English	English
silencieux ne mangeait	French	2.5
pas et le	French	4.5
refrain des chansons	French	4.5
qu'il avait l'habitude	French	0.5
de fredonner mourait	French	1.5
sur ses lèvres	French	4.5
Claudine ne voulait	French	4.5
pas parler de	French	4.5
peur d'éclater en	French	4.5
sanglots elle se	French	2.5
détournait parfois pour	French	4.5
s'essuyer les yeux	French	4.5
et s'efforçaient de	French	4.5
paraître calmes mais	French	4.5
les morceaux qu'ils	French	4.5
portaient à la	French	4.5
bouche ils les	French	4.5
reposaient intacts sur	French	4.5
leur assiette la	French	4.5
veillée le père	French	4.5
embrassa ses trois	French	4.5
enfants il retint	English	English
plus longtemps sur	French	4.5
son coeur Va	French	4.5
dormir lui ditil	French	4.5
mais auparavant demande	French	4.5
à du courage	English	English
pour la vie	French	4.5
qui demain commence	French	0.5
pour toi Le	French	4.5
père se retira	French	0.5
et les trois	French	4.5
enfants se prirent	French	4.5
à pleurer ni	French	4.5
l'un ni l'autre	French	4.5
n'avait la force	French	1.5
d'exprimer son chagrin	French	2.5
et chacun d'eux	French	4.5
trouvait moins de	French	4.5
paroles à dire	French	4.5
que de baisers	English	English
à donner la	French	4.5
pointe du jour	French	4.5
la famille se	French	2.5
réunit au seuil	French	4.5
de la porte	French	4.5
avait chaussé de	French	4.5
gros souliers et	French	4.5
des guêtres une	French	4.5
ceinture de cuir	French	4.5
serrait sa blouse	English	English
de toile autour	French	4.5
de sa taille	French	4.5
un petit havresac	French	1.5
pendait sur ses	French	4.5
épaules et sa	French	4.5
main était armée	French	4.5
d'un fort bâton	French	0.5
de houx et	French	4.5
Claudine sanglotaient était	French	4.5
un peu pâle	French	4.5
mais son regard	English	English
avait repris toute	French	2.5
son assurance et	French	4.5
sa fermeté Où	French	4.5
vastu mon fils	English	English
dit le père	French	4.5
Déjà à cette	French	4.5
époque était la	French	4.5
ville magique le	French	4.5
centre radieux qui	French	4.5
sollicitait toutes les	French	4.5
intelligences actives les	French	4.5
esprits audacieux les	French	4.5
imaginations inquiètes n'avait	French	4.5
pas un instant	French	2.5
songé aux détails	French	4.5
du parti extrême	French	4.5
qu'il avait choisi	French	4.5
cependant à la	French	4.5
question de son	French	4.5
père il répondit	French	4.5
sans hésiter A	English	English
C'est une grande	French	4.5
ville pleine de	French	4.5
périls et de	French	4.5
surprises y sont	French	4.5
arrivés pauvres comme	French	4.5
toi qui en	French	4.5
sont partis riches	English	English
mais mieux vaut	French	4.5
en sortir misérable	French	4.5
que d'y laisser	French	4.5
l'honnêteté te bénisse	French	4.5
mon fils Jacques	English	English
s'agenouilla entre son	French	4.5
frère et sa	French	4.5
soeur et posa	English	English
ses mains tremblantes	English	English
sur le jeune	French	4.5
front de son	French	4.5
premierné qu'il se	French	2.5
fut relevé le	French	4.5
père voulut glisser	English	English
dans la main	French	1.5
de une bourse	English	English
où brillait de	French	4.5
l'or mais la	French	4.5
lui rendit Gardez	French	4.5
cet or lui	French	4.5
ditil c'est la	French	4.5
dot de j'ai	French	4.5
des bras et	French	4.5
dans mon havresac	French	1.5
cinquante livres que	French	4.5
j'ai gagnées Le	French	4.5
père n'insista pas	French	4.5
mais tirant de	French	4.5
son sein un	French	4.5
bijou attaché à	French	2.5
un ruban il	French	2.5
le passa au	French	4.5
cou de Le	French	4.5
reconnaistu lui ditil	French	4.5
c'est le médaillon	French	4.5
perdu par l'étranger	French	4.5
il y a	English	English
cinq ans l'as	English	English
bien gagné gardele	French	1.4999999999999998
donc si tu	English	English
retrouves le gentilhomme	French	4.5
auquel il appartient	English	English
tu le lui	French	4.5
rendras et peutêtre	French	4.5
se rappelleratil l'hospitalité	French	0.5
de notre toit	French	2.5
Embrassonsnous maintenant et	French	4.5
que te conduise	French	0.5
Jacques embrassa d'abord	English	English
et était restée	French	4.5
un peu en	French	4.5
arrière quand ce	French	4.5
fut à son	French	4.5
tour elle sauta	French	1.5
au cou de	French	4.5
Je t'embrasse pour	French	4.5
moi d'abord lui	French	4.5
ditelle tout bas	French	2.5
si bas que	French	4.5
sa voix glissait	French	1.5
comme un souffle	French	1.5
à l'oreille du	French	4.5
voyageur à présent	French	4.5
c'est pour elle	French	4.5
Jacques tressaillit Oui	French	4.5
pour elle reprit	English	English
sa soeur ellemême	French	4.5
me l'a bien	French	4.5
recommandé Jacques serra	French	0.5
sur son coeur	English	English
avec passion au	French	4.5
souvenir de Suzanne	French	2.5
regarda le ciel	French	4.5
plein d'un courage	English	English
nouveau l'oeil brillant	English	English
d'espoir premières clartés	French	4.5
du jour s'épanchaient	French	4.5
sur les campagnes	English	English
humides à l'horizon	French	0.5
flottaient mille vapeurs	French	1.5
dorées et la	French	4.5
route se perdait	English	English
au milieu des	French	4.5
solitudes baignées de	French	4.5
lumière était làbas	French	4.5
derrière cet horizon	English	English
flamboyant était le	French	4.5
prix du triomphe	English	English
Jacques s'arracha des	French	4.5
bras de et	French	4.5
partit III UN	French	4.5
A quelques centaines	French	0.5
de pas de	French	4.5
la maisonnette la	French	4.5
route faisait un	French	4.5
coude et gravissait	French	4.5
un monticule au	French	4.5
sommet se retourna	French	1.5
le seuil de	French	4.5
la porte était	French	4.5
debout et près	French	4.5
de lui agenouillés	French	0.5
sur la terre	French	2.5
et tenant ses	French	4.5
mains entre les	French	4.5
leurs lui laissait	French	4.5
tout son bonheur	French	2.5
tout ce qu'il	French	4.5
avait aimé le	French	4.5
jardin plein d'ombre	French	4.5
et de fraîcheur	French	4.5
la tranquille retraite	English	English
où il avait	French	4.5
bégayé sa première	French	4.5
prière et rêvé	French	4.5
ses premiers rêves	French	4.5
d'amour les grandes	French	4.5
campagnes qui avaient	French	4.5
protégé son âme	French	4.5
de leur solitude	French	0.5
et de leur	French	4.5
sérénité le vaste	English	English
château voilé de	French	4.5
vieux ormeaux où	French	4.5
si souvent il	French	2.5
avait soupiré sans	French	4.5
savoir la cause	English	English
de ses soupirs	English	English
aux bruits innocents	English	English
de deux lèvres	French	4.5
enfantines chantant une	French	4.5
chanson du pays	French	4.5
boeufs fauves égarés	French	4.5
dans les grasses	English	English
prairies les taureaux	French	4.5
ruminant à l'ombre	French	1.5
des hêtres le	French	4.5
troupeau filant le	French	4.5
long du sentier	French	0.5
les noirs essaims	English	English
des corneilles dispersés	French	4.5
autour des chênes	French	4.5
la jeune fille	English	English
passant pieds nus	English	English
le ruisseau babillard	English	English
le lourd fermier	French	2.5
pressant l'attelage paresseux	French	4.5
et jusqu'aux alouettes	English	English
blotties aux creux	French	4.5
des sillons ou	French	4.5
perdues dans l'azur	French	2.5
immense tous les	French	4.5
êtres et toutes	French	2.5
les choses de	French	4.5
la création avaient	French	4.5
une part dans	French	4.5
cette vie qui	French	4.5
s'était épanchée comme	French	4.5
une onde limpide	French	1.5
et fraîche entre	French	4.5
deux rives d'herbes	English	English
molles lui c'était	French	4.5
le repos et	French	4.5
la paix c'était	French	4.5
l'inconnu et ses	French	4.5
hasards sans nombre	French	4.5
devant lui Jacques	English	English
s'appuya sur le	French	4.5
bâton de houx	English	English
et promena ses	French	4.5
regards au loin	French	1.5
mille souvenirs oubliés	French	4.5
s'éveillèrent en foule	English	English
dans son coeur	English	English
longtemps il écouta	French	4.5
leurs voix confuses	English	English
qui se redisaient	English	English
le passé tout	French	2.5
plein de douces	English	English
joies et d'honnêtes	French	4.5
labeurs et se	French	2.5
plut à leurs	French	4.5
récits mystérieux les	French	4.5
yeux tournés vers	English	English
les beaux ombrages	French	1.5
qui faisaient à	French	2.5
Malzonvilliers une verte	French	4.5
ceinture larmes qui	French	4.5
vinrent mouiller ses	French	4.5
mains sans qu'il	French	4.5
les eût senties	English	English
couler sur ses	French	4.5
joues le tirèrent	French	4.5
de son rêve	French	4.5
d'autres n'étaient pas	French	4.5
déjà tombées sur	French	4.5
la poussière Jacques	English	English
secoua la tête	French	4.5
et s'élança sur	French	4.5
le revers du	French	4.5
monticule avoir passé	French	4.5
la nuit à	French	2.5
il arriva le	French	4.5
lendemain à Dans	French	4.5
l'auberge où il	French	2.5
s'arrêta quelques rouliers	English	English
assis autour d'une	French	4.5
table dépeçaient un	French	4.5
quartier de mouton	English	English
ils causaient vivement	French	1.5
entre eux et	French	4.5
remarqua avec surprise	English	English
que leurs chariots	English	English
étaient encore tout	French	2.5
attelés sur la	French	4.5
route les animaux	French	0.5
débridés seulement mangeaient	French	2.5
à même leur	French	4.5
provende étalée par	French	4.5
terre premiers mots	English	English
qu'il entendit Jacques	English	English
comprit qu'une troupe	French	2.5
de batteurs d'estrade	English	English
avait pénétré dans	French	4.5
le pays entre	French	4.5
et appartenaient disaiton	French	0.5
à un corps	English	English
de soldats hongrois	English	English
et croates que	French	4.5
le gouvernement espagnol	English	English
avait licenciés et	French	4.5
qui cherchaient à	French	2.5
ramasser un gros	French	0.5
butin avant de	French	4.5
quitter la Les	French	4.5
habitants aisés se	French	2.5
retiraient en toute	French	2.5
hâte du côté	French	4.5
de ou de	French	4.5
les autres cachaient	French	4.5
leurs objets les	French	4.5
plus précieux voyait	French	1.5
des femmes et	French	4.5
des enfants sur	French	4.5
les voitures des	French	4.5
rouliers et de	French	4.5
temps en temps	French	2.5
passaient sur la	French	4.5
route des familles	English	English
de gentilshommes accompagnées	French	4.5
de leurs serviteurs	French	4.5
armés jusqu'aux dents	English	English
était habitué à	French	2.5
ces scènes de	French	4.5
tumulte et de	French	4.5
terreur s'avança vers	English	English
l'un des rouliers	English	English
et lui demanda	English	English
si les ennemis	French	4.5
étaient encore bien	French	4.5
loin Qui le	French	4.5
sait répondit l'homme	French	4.5
à dix lieues	French	4.5
peutêtre à cent	French	0.5
pas hussards vont	French	0.5
vite et mieux	French	4.5
vaut être entre	French	4.5
de bonnes murailles	French	1.5
que par chemins	English	English
Parmi ceux qui	French	4.5
décampaient en toute	French	2.5
hâte personne n'avait	French	4.5
encore rien vu	French	4.5
cependant nul ne	French	4.5
s'arrêtait et n'osait	French	1.5
même retourner la	French	4.5
tête Jacques pensa	French	0.5
que chacun fuyait	French	2.5
parce qu'il voyait	French	1.5
fuir les autres	French	4.5
et en garçon	French	4.5
résolu qu'il était	French	4.5
il prit le	French	4.5
parti de continuer	French	4.5
son chemin voulant	French	4.5
arriver à avant	French	4.5
la nuit journée	French	4.5
était brûlante et	French	4.5
Jacques marchait depuis	French	4.5
le matin l'appétit	French	4.5
commença de se	French	2.5
faire sentir avec	French	2.5
la fatigue ni	French	4.5
ni se jeta	French	1.5
sur le côté	French	4.5
de la route	English	English
près d'une fontaine	French	4.5
qui coulait à	French	2.5
l'ombre d'un bouquet	French	1.5
d'arbres et tirant	French	0.5
de sa valise	French	0.5
quelques provisions dont	French	4.5
il s'était muni	French	0.5
à il se	French	2.5
mit à déjeuner	French	4.5
gaillardement ce lieu	French	4.5
l'herbe était épaisse	French	4.5
et l'ombre fraîche	French	4.5
regarda sur la	French	4.5
route et ne	French	4.5
voyant rien ni	French	4.5
fantassin ni cavalier	French	0.5
il s'étendit comme	French	4.5
un berger de	French	4.5
au pied d'un	French	4.5
hêtre pensa d'abord	English	English
et beaucoup à	French	2.5
Mlle de et	French	4.5
soupira puis au	French	4.5
souvenir des bonnes	French	4.5
gens qu'il avait	French	4.5
rencontrés fuyant comme	French	4.5
des lièvres il	French	2.5
sourit il allait	French	0.5
sans doute penser	French	0.5
à bien d'autres	French	4.5
choses encore quand	English	English
il s'endormit Jacques	English	English
ne voulait que	French	4.5
se reposer mais	French	4.5
la jeunesse propose	English	English
et l'herbe fraîche	French	4.5
dispose dormait donc	French	4.5
comme on dort	French	1.5
à dixhuit ans	English	English
lorsqu'un grand bruit	English	English
de chevaux hennissant	French	1.5
et piaffant le	French	4.5
réveilla en sursaut	French	1.5
Sept ou huit	French	4.5
cavaliers tournaient autour	French	4.5
de lui tandis	English	English
que deux autres	French	4.5
débouclaient son havresac	French	1.5
après être sautés	French	4.5
de selle se	French	2.5
dressa d'un bond	English	English
et du premier	French	4.5
coup de poing	English	English
fit rouler à	French	2.5
terre l'un des	French	4.5
pillards il allait	French	0.5
prendre l'autre à	French	2.5
la gorge lorsque	French	4.5
trois ou quatre	French	0.5
cavaliers fondirent sur	French	4.5
lui et le	French	4.5
renversèrent avant qu'il	French	4.5
pût se relever	English	English
un coup violent	English	English
l'étourdit et il	French	2.5
resta couché aux	French	4.5
pieds des chevaux	French	4.5
Il n'avait fallu	English	English
que trois minutes	English	English
aux cavaliers pour	French	4.5
déboucler sa valise	French	0.5
il ne leur	French	4.5
en fallut pas	French	4.5
deux pour piller	English	English
l'argent et les	French	4.5
effets dépouiller de	French	4.5
son habit et	French	4.5
disparaître au galop	English	English
resta quelques instants	French	2.5
immobile étendu sur	French	4.5
le dos larges	English	English
bords de son	French	4.5
chapeau de feutre	French	4.5
ayant amorti la	French	4.5
force du coup	English	English
qui lui était	French	4.5
destiné n'était qu'étourdi	French	4.5
il se releva	French	0.5
à moitié nu	French	4.5
et sans argent	English	English
il courut sur	French	4.5
un tertre pour	French	4.5
reconnaître le chemin	English	English
qu'avaient pris les	French	4.5
pillards tourbillon de	French	4.5
fumée fouettée par	French	4.5
le vent ondulait	English	English
dans la plaine	French	0.5
deux villages brûlaient	French	4.5
entre les toits	French	2.5
de chaume tout	French	2.5
pétillants passaient les	French	4.5
bestiaux épouvantés nuage	English	English
lourd et criblé	French	0.5
d'étincelles s'épandait au	French	4.5
loin quand l'incendie	French	0.5
gagnait une meule	French	4.5
de paille ou	French	4.5
quelque grange emplie	French	0.5
de foin un	French	4.5
jet de flamme	English	English
coupait le sombre	French	4.5
rideau de ses	French	4.5
éclairs rouges et	French	4.5
tordus gros de	French	4.5
cavalerie se tenait	French	4.5
en bataille sur	French	4.5
le bord d'un	French	4.5
ruisseau n'en avait	French	4.5
jamais vu l'uniforme	French	1.5
qui se composait	English	English
d'un habit blanc	English	English
à retroussis jaunes	French	1.5
et d'une culotte	English	English
noire sa tête	French	4.5
allant et venant	French	4.5
d'un bout de	French	4.5
l'escadron à l'autre	French	4.5
marchait un cavalier	French	0.5
qu'à sa mine	French	2.5
on reconnaissait pour	French	4.5
le chef courut	French	1.5
droit à lui	French	4.5
ne doutait pas	French	4.5
qu'il n'eût eu	French	0.5
affaire à des	French	4.5
maraudeurs du parti	French	4.5
ennemi mais dans	French	4.5
son naïf sentiment	French	0.5
d'équité il ne	French	4.5
doutait pas non	French	4.5
plus que le	French	4.5
chef ne lui	French	4.5
fît rendre ce	French	4.5
qu'on lui avait	French	4.5
volé le roi	French	4.5
d'Espagne et l'empereur	English	English
d'Allemagne faisaient la	French	4.5
guerre au roi	French	4.5
de ils ne	French	4.5
la devaient pas	French	4.5
faire aux voyageurs	French	1.5
la vue d'un	French	4.5
jeune homme qui	French	4.5
s'avançait vers eux	French	4.5
au pas de	French	4.5
course nutête et	French	4.5
sans habit le	French	4.5
capitaine s'arrêta Que	French	4.5
veuxtu lui ditil	French	4.5
brusquement quand fut	English	English
à deux pas	French	4.5
de son cheval	English	English
Justice répondit tranquillement	French	4.5
Le chef sourit	French	0.5
et passa ses	French	4.5
longs doigts nerveux	French	4.5
dans sa moustache	English	English
Deux cavaliers qui	French	4.5
le suivaient échangèrent	French	4.5
quelques paroles rapides	French	4.5
ils parlaient plutôt	French	4.5
du gosier que	French	4.5
des lèvres et	French	4.5
leur idiome frappait	French	1.5
les oreilles de	French	4.5
comme le croassement	English	English
des corbeaux De	French	4.5
quoi te plainstu	English	English
reprit le chef	English	English
On m'a pris	French	4.5
ma valise l'argent	French	1.5
les effets qu'elle	French	4.5
contenait jusqu'à mes	French	4.5
habits tout On	English	English
t'a laissé ta	English	English
peau et tu	English	English
te plains drôle	French	4.5
tu es exigeant	French	2.5
Jacques crut n'avoir	French	4.5
pas bien entendu	French	4.5
Mais je vous	French	4.5
dis Et moi	French	4.5
je te dis	French	1.5000000000000002
de te taire	French	4.5
s'écria le chef	English	English
tu répondras quand	English	English
on t'interrogera Le	French	4.5
chef se tourna	English	English
vers ses officiers	English	English
pendant leur courte	English	English
conférence Jacques se	French	2.5
croisa les bras	English	English
de fuir ne	French	4.5
lui vint même	French	4.5
pas il lui	French	4.5
semblait impossible qu'on	French	4.5
lui fît plus	French	4.5
qu'il n'avait souffert	French	0.5
es sans doute	French	4.5
reprit le chef	English	English
en revenant vers	English	English
lui Oui De	French	4.5
ce pays peutêtre	French	4.5
De Tu dois	French	4.5
connaître alors les	French	4.5
chemins de traverse	English	English
pour regagner les	French	4.5
frontières de la	French	4.5
Très bien Tu	English	English
vas donc nous	French	4.5
servir de guide	English	English
jusquelà que tes	English	English
compatriotes décampent comme	French	4.5
des volées de	French	4.5
canards à notre	French	4.5
approche je crois	French	4.5
que nous nous	French	4.5
sommes avancés trop	French	2.5
loin assez de	French	4.5
butin comme ça	French	4.5
Cependant s'il y	French	0.5
a quelques bons	French	2.5
châteaux aux environs	French	4.5
tu nous y	French	0.5
conduiras route Jacques	English	English
ne bougea pas	French	4.5
M'astu entendu reprit	English	English
le chef en	French	4.5
le touchant du	French	4.5
bout de sa	French	4.5
houssine Parfaitement Alors	French	2.5
marche Non pas	French	4.5
je reste Tu	English	English
restes s'écria le	French	4.5
chef et poussant	French	4.5
son cheval il	French	2.5
vint heurter Jacques	English	English
immobile Le tube	English	English
glacé d'un pistolet	English	English
s'appuya sur le	French	4.5
front de Ah	English	English
çà saistu bien	French	4.5
que je n'aurais	French	4.5
qu'à remuer le	French	4.5
doigt pour te	French	2.5
faire sauter la	French	4.5
cervelle manant reprit	English	English
le Remuezle donc	French	4.5
car pour je	French	4.5
ne vous servirai	French	4.5
pas de guide	English	English
dans mon pays	French	4.5
et contre les	French	4.5
miens Le pistolet	English	English
se balança un	French	4.5
instant à la	French	4.5
hauteur du visage	French	0.5
de puis s'abaissa	French	4.5
lentement Ainsi tu	English	English
ne veux pas	French	4.5
nous conduire aux	French	4.5
frontières ajouta le	French	4.5
chef en glissant	French	1.5
le pistolet sous	French	4.5
l'arçon Je ne	French	4.5
le peux pas	French	4.5
C'est donc moi	French	4.5
qui t'y conduirai	French	4.5
Le chef dit	French	1.5
quelques mots dans	French	4.5
une langue étrangère	French	4.5
et avant que	French	4.5
Jacques pût se	French	2.5
douter du danger	French	0.5
qui le menaçait	French	4.5
trois ou quatre	French	0.5
soldats l'avaient saisi	French	0.5
et garrotté Il	French	2.5
y a bien	French	4.5
dans la compagnie	French	0.5
quelque vieux licol	English	English
propre à te	French	2.5
servir de cravate	French	0.5
continua le chef	English	English
en s'adressant à	French	2.5
nous toucherons aux	French	4.5
limites de l'Artois	French	4.5
je prétends t'y	English	English
laisser pendu à	French	2.5
la plus belle	English	English
branche du plus	French	4.5
beau chêne afin	French	2.5
que tu serves	French	0.5
d'exemple aux habitants	English	English
de l'endroit les	French	4.5
corbeaux te le	French	4.5
permettent mon drôle	French	4.5
tu auras le	French	4.5
loisir d'y méditer	French	4.5
sur les profits	English	English
de l'honnêteté Sur	French	4.5
un signe du	French	4.5
chef deux soldats	English	English
jetèrent en croupe	French	2.5
d'un cavalier on	English	English
le lia à	French	2.5
la selle comme	French	4.5
un sac et	French	4.5
toute la troupe	French	2.5
partit au trot	English	English
du côté de	French	4.5
courbé en deux	French	4.5
battait de sa	French	4.5
tête et de	French	4.5
ses pieds les	French	4.5
flancs du cheval	English	English
le sang se	French	2.5
porta bientôt aux	French	4.5
extrémités sa face	French	4.5
devint pourpre ses	French	4.5
yeux s'injectèrent un	French	4.5
bourdonnement douloureux et	French	4.5
confus emplit ses	French	4.5
oreilles le nom	English	English
de Suzanne expira	English	English
sur ses lèvres	French	4.5
et il ferma	French	0.5
ses paupières au	French	4.5
moment où le	French	4.5
voile rouge qui	French	4.5
flottait devant ses	French	4.5
yeux à demi	English	English
clos obscurcissait le	French	4.5
plus son esprit	English	English
il ramena par	French	4.5
un effort violent	English	English
ses mains à	French	2.5
la hauteur de	French	4.5
sa tête un	French	4.5
instant soulevée courroies	French	4.5
qui les enchaînaient	French	4.5
touchaient à ses	French	4.5
lèvres il les	French	4.5
mordit et l'instinct	English	English
de la conservation	English	English
revenant avec l'espoir	French	4.5
de la délivrance	French	4.5
il en eut	French	4.5
bien vite à	French	2.5
coups de dents	English	English
déchiré le noeud	English	English
cavalier chantait tout	French	2.5
en fourbissant la	French	4.5
garde de son	French	4.5
sabre se suspendit	English	English
d'une main à	French	2.5
la croupière du	French	4.5
cheval et de	French	4.5
l'autre défit le	French	4.5
lien qui l'attachait	English	English
à la selle	French	4.5
il sentit ses	French	4.5
membres libres il	French	2.5
regarda autour de	French	4.5
lui pour voir	French	4.5
si nul soldat	English	English
ne l'observait le	French	4.5
chef et les	French	4.5
officiers chevauchaient en	French	4.5
tête et l'escadron	French	4.5
les suivait sans	French	4.5
penser au captif	English	English
Le cavalier tout	French	2.5
occupé de son	French	4.5
arme ne pressait	French	4.5
pas son cheval	English	English
qui plus lourdement	French	1.5
chargé que les	French	4.5
autres avait perdu	French	0.5
du terrain et	French	4.5
se trouvait alors	French	2.5
à la queue	French	4.5
de la colonne	French	4.5
se laissa donc	French	4.5
glisser doucement sur	French	4.5
le chemin peine	French	2.5
eutil senti la	French	4.5
terre sous ses	French	4.5
pieds que toute	French	2.5
sa vigueur lui	French	4.5
revint et se	French	2.5
jetant sur le	French	4.5
côté de la	French	4.5
route il prit	French	0.5
à travers champs	English	English
il avait à	French	2.5
peine fait deux	French	4.5
cents pas qu'il	French	4.5
entendit une détonation	French	4.5
et au même	French	4.5
instant une balle	English	English
fit jaillir la	French	4.5
poussière à ses	French	4.5
côtés tourna la	French	4.5
tête et vit	French	0.5
trois ou quatre	French	0.5
cavaliers lancés à	French	2.5
ses trousses le	French	4.5
mousqueton au poing	English	English
Jacques était leste	French	0.5
et vigoureux il	French	2.5
franchissait les haies	French	4.5
et les fossés	French	4.5
comme un chevreuil	French	4.5
mais il ne	French	4.5
pouvait longtemps lutter	English	English
contre des chevaux	French	4.5
cavalier à qui	French	4.5
sa garde avait	French	4.5
été confiée se	French	2.5
montrait le plus	French	4.5
ardent à sa	French	4.5
poursuite déjà il	French	2.5
était en avance	French	4.5
de quelques centaines	French	0.5
de pas sur	French	4.5
ses camarades lorsque	French	4.5
comprenant l'inutilité de	French	4.5
sa fuite s'arrêta	French	4.5
cavalier arriva sur	French	4.5
lui au galop	English	English
le sabre levé	French	4.5
mais évita le	French	4.5
coup en se	French	2.5
jetant de côté	French	4.5
et saisissant le	French	4.5
soldat par la	French	4.5
jambe gauche il	French	2.5
le précipita à	French	2.5
bas du cheval	English	English
que le soldat	English	English
meurtri de sa	French	4.5
chute se débattait	French	4.5
à terre Jacques	English	English
sauta sur la	French	4.5
selle et partit	French	0.5
quelques minutes les	French	4.5
camarades du vaincu	French	4.5
bondirent sur ses	French	4.5
traces deux ou	French	4.5
trois balles égratignèrent	French	4.5
le sol à	French	2.5
ses côtés mais	French	4.5
bientôt la course	English	English
des maraudeurs se	French	2.5
ralentit l'escadron était	French	4.5
loin derrière eux	French	4.5
et en avant	French	4.5
s'étendait un pays	French	4.5
inconnu où l'ennemi	English	English
pouvait surgir à	French	2.5
tout instant l'un	French	4.5
d'eux retint son	French	4.5
cheval et tourna	English	English
bride le second	English	English
l'imita puis le	French	4.5
troisième aussi et	French	4.5
n'entendit plus retentir	English	English
à son oreille	English	English
leur galop furieux	French	4.5
son tour il	French	2.5
ramassa les rênes	French	4.5
et mit sa	French	4.5
monture au petit	English	English
trot n'avait pas	French	4.5
marché un quart	English	English
d'heure dans la	French	4.5
direction de SaintPol	English	English
qu'il découvrit en	French	4.5
avant de une	French	4.5
troupe de cavaliers	French	0.5
portant de l'infanterie	English	English
en croupe première	French	4.5
rencontre avait appris	French	2.5
au fils du	French	4.5
fauconnier assez des	French	4.5
usages de la	French	4.5
guerre pour le	French	4.5
rendre circonspect moment	French	1.5
il eut la	French	4.5
pensée de se	French	2.5
jeter dans un	French	4.5
petit bois lorsqu'une	French	4.5
nouvelle réflexion le	French	4.5
décida à pousser	French	0.5
droit en avant	French	4.5
Il était trop	French	2.5
près de ville	French	0.5
forte occupée par	French	4.5
une grosse garnison	French	1.5
pour que l'ennemi	English	English
eût osé s'aventurer	English	English
jusquelà vedette qui	French	4.5
trottait à deux	French	4.5
ou trois cents	French	0.5
pas de la	French	4.5
troupe étonnée de	French	4.5
voir un grand	English	English
garçon n'ayant qu'un	French	4.5
pantalon et la	French	4.5
chemise courant sur	French	4.5
un cheval tout	French	2.5
équipé arrêta Conduisezmoi	French	4.5
à votre capitaine	French	0.5
dit au plus	French	4.5
apparent de la	French	4.5
bande C'est ce	French	4.5
que j'allais justement	English	English
vous proposer mon	French	4.5
camarade répondit le	French	4.5
brigadier Le capitaine	French	0.5
était un beau	French	2.5
jeune homme dont	French	4.5
la bonne mine	French	2.5
était rehaussée par	French	4.5
le costume militaire	French	4.5
une fine moustache	English	English
noire faisait ressortir	French	4.5
l'éclat de ses	French	4.5
lèvres du galbe	English	English
le plus pur	English	English
grande pâleur répandue	French	4.5
sur ses traits	French	4.5
délicats donnait à	French	2.5
sa physionomie un	French	4.5
charme et une	French	4.5
distinction inexprimables se	French	2.5
sentit rassuré du	French	4.5
premier regard ou	French	4.5
ennemi il avait	French	4.5
affaire à un	French	4.5
brave gentilhomme L'officier	French	2.5
considéra un instant	French	2.5
en silence et	French	4.5
un rapide sourire	French	4.5
éclaira son visage	French	0.5
où la mélancolie	French	4.5
avait jeté son	French	4.5
voile mystérieux Si	French	4.5
tu es ditil	French	4.5
enfin d'une voix	French	4.5
claire et douce	English	English
ne crains rien	French	4.5
tu es parmi	English	English
des Jacques lui	French	4.5
raconta ce qui	French	4.5
lui était arrivé	French	0.5
son sommeil sa	French	4.5
capture sa délivrance	French	4.5
le péril auquel	French	4.5
il avait échappé	French	4.5
l'écoutait frisant le	French	4.5
bout de sa	French	4.5
moustache les yeux	French	4.5
attachés sur les	French	4.5
yeux du jeune	French	4.5
homme comprit la	French	4.5
signification de ce	French	4.5
regard rougit Vous	French	4.5
me prenez pour	French	4.5
un espion ditil	French	4.5
d'une voix brève	French	4.5
Plus maintenant la	French	4.5
lâcheté n'a pas	French	4.5
ces traits honnêtes	French	4.5
et ce regard	English	English
fier tremble mais	French	4.5
ne rougit pas	French	4.5
es un brave	English	English
garçon et tu	English	English
vas nous conduire	French	4.5
au lieu où	French	4.5
tu as laissé	French	4.5
les batteurs d'estrade	English	English
Volontiers quand je	French	4.5
les perdis de	French	4.5
vue ils prenaient	French	4.5
le chemin de	French	4.5
l'abbaye de près	French	4.5
de et ne	French	4.5
peuvent pas être	French	4.5
à plus d'une	French	4.5
lieue d'ici Sur	French	4.5
l'ordre du capitaine	French	0.5
on fournit à	French	2.5
un habit un	French	4.5
chapeau un sabre	French	1.5
et des pistolets	English	English
Astu jamais manié	French	4.5
ces joujouxlà reprit	English	English
l'officier Vous en	French	4.5
jugerez mon capitaine	French	0.5
si nous rencontrons	French	0.5
les bandits qui	French	4.5
m'ont pillé Va	French	4.5
donc Jacques se	French	2.5
plaça à la	French	4.5
tête de la	French	4.5
troupe qui se	French	2.5
composait de deux	French	4.5
cents cavaliers à	French	2.5
peu près portant	French	4.5
en croupe autant	French	0.5
de grenadiers venait	French	4.5
d'être détachée de	French	4.5
la garnison de	French	4.5
pour repousser les	French	4.5
maraudeurs de l'armée	French	4.5
espagnole signalés par	French	4.5
les éclaireurs L'officier	French	2.5
trottait à côté	French	4.5
de Tu manies	English	English
ton cheval comme	French	4.5
un vieux soldat	English	English
lui ditil au	French	4.5
bout de cinq	French	0.5
minutes donc astu	English	English
appris l'équitation Chez	French	4.5
mon père à	French	2.5
Ah tu es	French	0.5
de alors tu	English	English
as peutêtre connu	French	4.5
un brave fauconnier	French	4.5
nommé Comment ne	French	4.5
l'auraisje pas connu	French	4.5
puisque c'est mon	French	4.5
père L'officier tressaillit	French	0.5
se tourna vers	English	English
et se prit	French	0.5
à le considérer	French	4.5
attentivement Ton père	French	4.5
vieux qui m'a	French	4.5
si souvent porté	French	4.5
sur ses genoux	French	0.5
est ton père	French	4.5
t'appelles donc Ce	French	4.5
fut au tour	French	2.5
de de tressaillir	French	4.5
regarda l'officier tout	French	2.5
ému cherchant à	French	2.5
lire sur son	French	4.5
visage un nom	English	English
que son coeur	English	English
épelait tout bas	French	2.5
Mon nom vous	French	4.5
savez mon nom	English	English
ditil L'officier lui	French	4.5
tendit la main	French	1.5
Astu donc oublié	French	0.5
d'Assonville repritil Notre	French	4.5
bienfaiteur à tous	French	2.5
s'écria Et il	French	2.5
attacha ses lèvres	French	4.5
sur la main	French	1.5
du capitaine Non	French	4.5
pas celuilà mais	French	4.5
son fils d'Assonville	English	English
père est làhaut	French	4.5
il a été	French	4.5
l'ami de le	French	4.5
fils sera l'ami	English	English
de IV L'ESCARMOUCHE	English	English
La troupe commandée	French	4.5
par d'Assonville capitaine	French	0.5
aux chevaulégers était	French	4.5
encore à dix	French	4.5
minutes de l'abbaye	English	English
de dont les	French	4.5
murailles blanches se	French	2.5
dessinaient entre des	French	4.5
massifs d'arbres sur	French	4.5
la droite du	French	4.5
chemin lorsqu'on entendit	French	0.5
des coups de	French	4.5
fusil pétiller à	French	2.5
une petite distance	English	English
Un paysan qui	French	4.5
fuyait sur un	French	4.5
méchant bidet apprit	English	English
à d'Assonville qu'une	French	4.5
vingtaine de maraudeurs	French	4.5
s'étaient présentés à	French	2.5
l'abbaye avaient forcé	French	4.5
les portes et	French	4.5
ordonné aux religieux	French	4.5
de préparer des	French	4.5
vivres pour toute	French	2.5
la troupe s'ils	English	English
ne voulaient pas	French	4.5
voir leur maison	French	4.5
mise à feu	French	4.5
et à sang	English	English
Qu'a fait l'abbé	English	English
demanda le capitaine	French	0.5
dont les yeux	French	4.5
s'enflammèrent Dame reprit	English	English
le paysan il	French	2.5
a vidé la	French	4.5
cave et fait	French	4.5
dresser les tables	French	0.5
Bien nous mangerons	French	2.5
le dîner après	French	4.5
le bal Hum	English	English
fit l'autre m'est	French	0.5
avis mon officier	English	English
que bien des	French	4.5
danseurs manqueront au	French	4.5
festin sont nombreux	French	4.5
Combien Mais six	English	English
ou sept cents	French	0.5
tous à cheval	English	English
et bien armés	French	4.5
chef a fait	French	4.5
sonner de la	French	4.5
trompette les bandes	English	English
dispersées de toutes	French	2.5
parts se sont	French	4.5
réunies et en	French	4.5
attendant que le	French	4.5
souper soit prêt	French	4.5
elles pilent Le	French	4.5
village était en	French	4.5
feu et la	French	4.5
fusillade éclatait dans	French	4.5
la plaine M	French	0.5
d'Assonville se dressa	French	0.5
sur ses étriers	French	0.5
l'épée à la	French	4.5
main n'était plus	French	4.5
le pâle jeune	French	4.5
homme au front	French	0.5
décoloré brillait dans	French	4.5
ses yeux le	French	4.5
sang brûlait sa	French	4.5
joue En avant	French	4.5
criatil d'une voix	French	4.5
tonnante et du	French	4.5
bout de son	French	4.5
épée il montra	French	0.5
à ses soldats	English	English
le village flamboyant	English	English
la troupe s'ébranla	French	4.5
A la vue	French	4.5
des les clairons	French	4.5
sonnèrent et les	French	4.5
ennemis se rangèrent	French	0.5
en bataille à	French	2.5
quelque distance d'Anvin	French	1.5
aux bords de	French	4.5
la troupe était	French	4.5
nombreuse et bien	French	4.5
montée mais d'Assonville	English	English
était de ceux	French	4.5
qui ne savent	French	0.5
pas reculer il	French	2.5
fit mettre pied	English	English
à terre aux	French	4.5
grenadiers et les	French	4.5
divisa par pelotons	French	1.4999999999999998
de vingt à	French	2.5
vingtcinq hommes entre	French	4.5
ses cavaliers Jouez	French	4.5
du fusil comme	French	4.5
nous jouerons du	French	4.5
sabre leur ditil	French	4.5
et nous ferons	French	4.5
passer la rivière	French	4.5
sans bateau à	French	2.5
ces méchants drôles	French	4.5
Les grenadiers crièrent	French	4.5
le roi et	French	4.5
apprêtèrent leurs armes	French	0.5
moment où d'Assonville	English	English
allait donner le	French	4.5
signal d'attaquer un	French	4.5
vieil officier lui	French	4.5
toucha légèrement le	French	4.5
bras Monsieur le	French	4.5
comte lui ditil	French	4.5
ils sont deux	French	4.5
contre un et	French	4.5
l'avantage de la	French	4.5
position est pour	French	4.5
eux Quoi c'est	French	4.5
vous monsieur du	French	4.5
qui comptez l'ennemi	English	English
Je dois compte	French	4.5
au roi mon	French	4.5
maître de la	French	4.5
vie de tous	French	2.5
ces braves gens	English	English
reprit l'officier en	French	4.5
montrant du bout	English	English
de son épée	French	4.5
les soldats impatients	French	0.5
ordonnez et vous	French	4.5
verrez si j'hésiterai	French	4.5
à me faire	French	4.5
tuer Non pas	French	4.5
monsieur vous triompherez	French	0.5
avec vos grenadiers	English	English
sont un contre	French	4.5
deux eh bien	French	4.5
nous avons pour	French	4.5
nous la vue	French	4.5
de ce village	French	0.5
qui brûle chaumière	French	4.5
qui croule crie	French	4.5
vengeance avant Toute	French	2.5
la troupe entendit	French	0.5
ces mots soldats	English	English
électrisés s'élancèrent et	French	4.5
emporté le premier	French	4.5
sentit courir dans	French	4.5
ses veines le	French	4.5
frisson de la	French	4.5
guerre après s'être	French	4.5
mis en bataille	French	4.5
attendaient les en	French	4.5
poussant mille cris	French	1.5
à la supériorité	French	4.5
du nombre ils	French	2.5
comptaient sur une	French	4.5
facile victoire bien	French	4.5
éloignés de mettre	French	4.5
la rivière entre	French	4.5
eux et les	French	4.5
assaillants ce qui	French	4.5
aurait doublé leurs	French	4.5
forces par l'avantage	French	4.5
de leur position	French	4.5
ils coururent à	French	2.5
leur rencontre pêlemêle	French	4.5
et sans ordre	French	2.5
aussitôt qu'ils les	French	4.5
virent s'ébranler choc	English	English
fut terrible la	French	4.5
fusillade éclata sur	French	4.5
toute la ligne	French	4.5
et les cavaliers	French	0.5
s'abordèrent le sabre	French	1.5
et le pistolet	English	English
au poing instant	French	2.5
on put croire	French	4.5
que le succès	French	0.5
serait douteux combattants	English	English
ne faisaient qu'une	French	4.5
masse mouvante étreinte	French	4.5
par la colère	French	4.5
et le sauvage	French	4.5
amour du sang	English	English
de cette masse	English	English
confuse montait un	French	4.5
bruit de fer	English	English
mêlé à des	French	4.5
hurlements de mort	English	English
A toute seconde	French	2.5
un homme disparaissait	French	4.5
du milieu de	French	4.5
cet océan de	French	4.5
têtes qu'entouraient mille	French	4.5
éclairs où sonnait	French	4.5
le cliquetis des	French	4.5
armes et l'espace	French	0.5
se resserrait mais	French	4.5
les décharges des	French	4.5
grenadiers de du	French	4.5
Coudrais qui combattaient	French	0.5
en bon ordre	French	2.5
avaient éclairci les	French	4.5
rangs de l'ennemi	English	English
les écrasés sous	French	4.5
une grêle de	French	4.5
balles partant de	French	4.5
tous les côtés	French	4.5
à la fois	French	4.5
pressés par la	French	4.5
fougue ardente des	French	4.5
cavaliers qu'enflammait l'exemple	French	4.5
de d'Assonville mollirent	French	4.5
et lâchèrent pied	English	English
Un soldat regarda	English	English
en arrière un	French	4.5
autre tourna bride	English	English
un troisième se	French	2.5
jeta tout armé	French	0.5
dans la dix	French	4.5
ou douze décampèrent	French	4.5
un escadron plia	English	English
tout entier puis	French	4.5
tous enfin reculèrent	French	0.5
dans un désordre	French	4.5
affreux En avant	French	4.5
cria de nouveau	French	4.5
d'Assonville et poussant	French	4.5
son cheval sur	French	4.5
les derniers combattants	English	English
il précipita toute	French	2.5
la troupe dans	French	4.5
la rivière Quand	English	English
les chevaux enfoncèrent	French	4.5
les pieds dans	French	4.5
l'eau ce fut	English	English
une déroute et	French	4.5
les partirent au	French	4.5
galop jetant leurs	French	4.5
mousquetons et le	French	4.5
sabre hacha les	French	4.5
fuyards Jacques voyait	French	1.5
pour la première	French	4.5
fois et de	French	4.5
près toutes les	French	4.5
horreurs d'un combat	English	English
faisait trembler ses	French	4.5
lèvres mais le	French	4.5
piaffement des chevaux	French	4.5
l'éclat des armes	French	0.5
le bruit des	French	4.5
explosions l'odeur de	French	4.5
la poudre excitaient	French	4.5
son jeune courage	English	English
il brandit son	French	4.5
sabre d'une main	French	1.5
ferme et se	French	2.5
lança tout droit	French	4.5
devant lui qu'il	French	4.5
heurta dans sa	French	4.5
course lui lâcha	French	4.5
à bout portant	French	4.5
un coup de	French	4.5
pistolet la balle	English	English
traversa le chapeau	French	1.5
de à deux	French	4.5
pouces du front	French	0.5
riposta par un	French	4.5
coup de pointe	French	1.5
furieux tomba sur	French	4.5
le dos les	French	4.5
bras étendus le	French	4.5
sabre lui était	French	4.5
entré dans la	French	4.5
gorge sentit jaillir	French	4.5
sur sa main	French	1.5
le sang bouillonnant	French	4.5
et chaud il	French	2.5
regarda le soldat	English	English
pâlissant qu'emportait le	French	4.5
cheval effaré le	French	4.5
premier homme qu'il	French	4.5
tuait Jacques abaissa	French	1.5
la pointe de	French	4.5
son sabre et	French	4.5
frissonna mais il	French	2.5
était au premier	French	4.5
rang et le	French	4.5
tourbillon le poussa	French	4.5
en avant milieu	French	4.5
de la mêlée	French	4.5
rencontra d'Assonville et	French	4.5
se tint dès	French	4.5
lors à son	French	4.5
côté deux les	French	4.5
premiers firent entrer	French	4.5
leurs chevaux dans	French	4.5
la rivière rougie	French	1.5
mais quand il	French	2.5
n'y eut plus	French	4.5
que des fuyards	English	English
tous deux remirent	English	English
leur sabre au	French	4.5
fourreau capitaine tendit	English	English
la main au	French	4.5
soldat Tu t'es	English	English
bien conduit lui	French	4.5
ditil tu avais	French	4.5
raison de vouloir	French	4.5
te mesurer contre	French	4.5
ces pillards leur	French	4.5
as payé la	French	4.5
monnaie de ta	English	English
valise Ma foi	French	4.5
monsieur j'ai fait	French	4.5
ce que j'ai	French	4.5
pu Eh mon	French	4.5
camarade ceux qui	French	4.5
courent te diront	French	4.5
que tu as	English	English
trop pu Le	French	4.5
champ de bataille	French	4.5
était encombré de	French	4.5
morts et de	French	4.5
blessés les ennemis	French	4.5
avaient laissé trois	French	4.5
cents des leurs	French	4.5
par terre une	French	4.5
centaine fort mal	English	English
accommodés étaient restés	French	4.5
aux mains des	French	4.5
si bien que	French	4.5
les batteurs d'estrade	English	English
avaient perdu la	French	4.5
moitié de leur	French	4.5
monde les clairons	French	4.5
sonnèrent et les	French	4.5
soldats dispersés de	French	4.5
toutes parts se	French	2.5
réunirent sous leurs	French	4.5
guidons Tu n'es	French	4.5
pas encore enrégimenté	French	4.5
mon garçon dit	French	1.5
d'Assonville à Jacques	English	English
ainsi va à	French	2.5
tes affaires que	French	4.5
tu as perdu	French	0.5
une valise ne	French	4.5
te fais pas	French	4.5
faute d'en ramasser	English	English
deux Comme d'Assonville	English	English
allait rejoindre son	French	4.5
escadron deux grenadiers	English	English
qui portaient un	French	4.5
brancard sur lequel	French	4.5
gisait un officier	English	English
vinrent à passer	French	4.5
près de lui	French	4.5
A la vue	French	4.5
du capitaine des	French	4.5
chevaulégers l'officier se	French	2.5
souleva sur son	French	4.5
coude Monsieur le	French	4.5
comte ditil vous	French	4.5
aviez raison et	French	4.5
je n'avais pas	French	4.5
tort Ils sont	French	4.5
battus mais ils	French	2.5
m'ont tué Tué	French	4.5
s'écria d'Assonville j'espère	French	4.5
monsieur du que	French	4.5
votre blessure Ma	French	4.5
blessure est mortelle	French	1.5
reprit le vieil	French	4.5
officier coup de	French	4.5
feu m'a traversé	French	4.5
le corps prudence	English	English
m'est expliquée à	French	2.5
présent c'était un	French	4.5
pressentiment revoir capitaine	French	0.5
M du laissa	French	4.5
tomber sa tête	French	4.5
où flottaient les	French	4.5
ombres du trépas	French	4.5
et les soldats	English	English
passèrent avait le	French	4.5
coeur serré l'éclat	French	4.5
et les transports	English	English
de la victoire	French	0.5
il venait d'assister	English	English
au deuil d'une	French	4.5
agonie prit dans	French	4.5
la direction de	French	4.5
la rivière la	French	4.5
tête penchée et	French	4.5
l'esprit malade déjà	French	4.5
la paix de	French	4.5
la maisonnette était	French	4.5
loin Il n'avait	French	4.5
pas fallu deux	French	4.5
journées pour que	French	4.5
eût tué quatre	French	0.5
ou cinq hommes	French	4.5
et qu'il en	French	4.5
eût blessé sept	English	English
ou huit autres	French	4.5
en marchant au	French	4.5
milieu des cadavres	French	4.5
ses yeux tombèrent	French	4.5
sur ses mains	French	4.5
elles étaient humides	English	English
et rouges encore	French	4.5
tout son corps	English	English
frissonna route allaitil	French	0.5
donc suivre pour	French	4.5
arriver jusqu'à et	French	4.5
quelles sanglantes prémices	French	4.5
son amour venaitil	French	4.5
de lui offrir	English	English
foulait en ce	French	4.5
moment l'endroit où	French	4.5
la mêlée avait	French	4.5
été le plus	French	4.5
furieuse la terre	French	2.5
était jonchée de	French	4.5
morts au milieu	French	4.5
des étendus ses	French	4.5
regards vagues et	French	4.5
distraits rencontrèrent un	French	4.5
soldat qui tombé	French	1.5
à vingt pas	French	4.5
de la Ternoise	English	English
cherchait à se	French	2.5
rapprocher du rivage	English	English
rampait sur les	French	4.5
mains et les	French	4.5
genoux se traînait	French	4.5
l'espace de quelques	French	4.5
pieds puis s'abattait	English	English
courut à lui	French	4.5
et le souleva	French	4.5
De l'eau de	French	4.5
l'eau dit le	French	4.5
dont la face	French	4.5
était souillée de	French	4.5
sang coagulé de	French	4.5
l'eau je brûle	French	4.5
Jacques le transporta	French	1.5
sur le bord	English	English
de la et	French	4.5
présenta à ses	French	4.5
lèvres ardentes un	French	4.5
chapeau rempli d'eau	French	4.5
Le trempa son	French	4.5
visage dans cette	French	4.5
eau froide et	French	4.5
but avidement J'ai	French	4.5
du feu dans	French	4.5
la gorge et	French	4.5
mes lèvres sont	French	4.5
comme deux fers	English	English
rouges disaitil en	French	4.5
léchant les bords	English	English
humides du chapeau	French	1.5
Jacques l'adossa contre	French	4.5
un tronc d'arbre	French	1.5
et lava son	French	4.5
visage avait reçu	French	4.5
un coup de	French	4.5
sabre sur la	French	4.5
tête et une	French	4.5
balle dans le	French	4.5
ventre Quand la	French	4.5
boue et le	French	4.5
sang effacés laissèrent	French	4.5
les traits à	French	2.5
découvert Jacques poussa	French	4.5
un cri blessé	French	4.5
leva les yeux	French	4.5
sur lui Ah	English	English
tu me reconnais	French	4.5
à présent ditil	French	4.5
avec un rire	French	4.5
amer tu m'as	English	English
soulevé je n'ai	French	0.5
rien dit j'avais	French	4.5
soif maintenant achèvemoi	French	4.5
si ça t'amuse	English	English
Oh fit avec	French	2.5
une expression d'horreur	English	English
Parbleu c'est ton	English	English
droit Un droit	French	4.5
d'assassin Ah tu	English	English
as de ces	French	4.5
scrupuleslà toi à	French	2.5
ton aise à	French	2.5
moi je n'y	English	English
regarderai pas de	French	4.5
si près si	French	4.5
quelque jour les	French	4.5
tiens m'ont mis	French	4.5
dans un trop	French	2.5
piteux état pour	French	4.5
que je recommence	French	0.5
jamais mon drôle	French	4.5
tu t'es bien	French	4.5
vengé Non pas	French	4.5
je me suis	French	4.5
battu voilà tout	French	2.5
Oh je ne	French	4.5
t'en veux pas	French	4.5
je t'avais cassé	French	4.5
la tête tout	French	2.5
cela ne serait	French	4.5
pas arrivé une	French	4.5
leçon il est	French	4.5
un peu tard	English	English
pour m'en servir	French	4.5
qu'elle te profite	English	English
au moins L'officier	French	2.5
se retourna sur	French	4.5
le flanc Voistu	French	1.5
repritil quand on	English	English
tient un ennemi	French	1.5
le plus court	English	English
est de lui	French	4.5
brûler la cervelle	French	4.5
un principe que	French	4.5
j'avais toujours mis	French	4.5
en pratique pour	French	4.5
l'avoir oublié une	French	4.5
fois voilà où	French	4.5
j'en suis réduit	French	4.5
Une convulsion serra	French	0.5
le gosier du	French	4.5
qui se tordit	English	English
au pied de	French	4.5
l'arbre De l'eau	French	4.5
de l'eau murmuratil	English	English
encore j'ai des	French	4.5
charbons dans les	French	4.5
entrailles Jacques posa	English	English
le chapeau plein	English	English
à son côté	French	4.5
et courut chercher	French	2.5
du secours Il	French	2.5
trouva d'Assonville inspectant	English	English
sa troupe suivi	French	4.5
d'un maréchal des	French	4.5
logis qui rayait	French	4.5
les noms des	French	4.5
morts sur le	French	4.5
livre de la	French	4.5
compagnie L'officier hongrois	English	English
qui voulait me	French	4.5
faire pendre aux	French	4.5
frontières de l'Artois	French	4.5
se meurt lui	French	4.5
dit ne pourraisje	French	4.5
pas le faire	French	4.5
transporter à l'ambulance	French	1.5
pour qu'il reçoive	French	4.5
les soins que	French	4.5
réclame son état	French	4.5
M d'Assonville regarda	English	English
Ah c'est le	French	4.5
capitaine qui voulait	French	4.5
te faire pendre	French	4.5
aux frontières de	French	4.5
l'Artois bien mon	French	4.5
garçon va Jacques	English	English
partit avec deux	French	4.5
grenadiers hongrois fut	English	English
placé sur un	French	4.5
brancard garni de	French	4.5
bottes de paille	French	4.5
gouttes de sang	English	English
se figeaient au	French	4.5
bord de ses	French	4.5
plaies ouvertes ses	French	4.5
dents claquaient de	French	4.5
froid Le fils	English	English
du fauconnier le	French	4.5
couvrit de son	French	4.5
habit Quel coeur	English	English
astu donc lui	French	4.5
dit brusquement l'officier	French	2.5
Le coeur de	French	4.5
tout le monde	French	4.5
Parbleu tu es	French	0.5
bien le premier	French	4.5
habitant de ce	French	4.5
mondelà que je	French	4.5
rencontre Les yeux	French	4.5
du brillaient et	French	4.5
s'éteignaient tour à	French	2.5
tour quand il	French	2.5
les ouvrait il	French	2.5
regardait Peutêtre vautil	French	0.5
mieux repritil que	French	4.5
ce soit moi	French	4.5
qui parte et	French	4.5
toi qui restes	French	4.5
ne vaux rien	French	4.5
et tu as	English	English
l'air d'un brave	English	English
jeune homme hasard	English	English
a eu raison	French	4.5
Le se tut	English	English
quelques minutes un	French	4.5
tressaillement convulsif l'agita	English	English
et ses yeux	French	4.5
se voilèrent tout	French	2.5
à coup il	French	2.5
les tourna vers	English	English
Jacques tout pleins	English	English
d'un feu extraordinaire	English	English
Croistu qu'il y	French	0.5
ait quelque chose	French	4.5
làhaut lui ditil	French	4.5
en montrant le	French	4.5
ciel du doigt	French	2.5
Il y a	English	English
Veuxtu me donner	French	4.5
la main Jacques	English	English
tendit sa main	French	1.5
au vieux soldat	English	English
qui la serra	French	0.5
avec plus de	French	4.5
vigueur qu'on ne	French	4.5
pouvait en attendre	French	4.5
d'un homme si	French	4.5
cruellement blessé puis	French	4.5
il se renversa	English	English
sur la paille	French	4.5
et ramena l'habit	French	0.5
de sur lui	French	4.5
bout d'un moment	French	1.5
ne l'entendant plus	French	4.5
ni parler ni	French	4.5
se plaindre se	French	2.5
pencha vers lui	French	4.5
Comment vous trouvezvous	French	4.5
mon capitaine lui	French	4.5
ditil Moi mon	French	4.5
ami très bien	French	4.5
Le regard était	French	4.5
vif le visage	French	0.5
doucement coloré la	French	4.5
voix claire se	French	2.5
tut pensant que	French	4.5
l'officier hongrois voulait	French	4.5
dormir on fut	English	English
arrivé à l'ambulance	French	1.5
il souleva l'habit	French	0.5
l'officier hongrois était	French	4.5
mort heures après	French	4.5
la troupe était	French	4.5
réunie à l'abbaye	English	English
de SaintGeorges autour	French	4.5
des tables préparées	French	4.5
pour les ennemis	French	4.5
riait de bon	English	English
coeur et on	English	English
mangeait de bon	English	English
appétit l'on plaignait	English	English
les blessés on	English	English
oubliait les morts	English	English
les vivants se	French	2.5
félicitaient les uns	English	English
les autres et	French	4.5
tout allait pour	French	4.5
le mieux d'Assonville	English	English
conduisit dans une	French	4.5
chambre de l'abbaye	English	English
où une table	English	English
était dressée Assiedstoi	English	English
là lui ditil	French	4.5
Moi près de	French	4.5
vous Après le	French	4.5
combat il n'y	English	English
a plus ni	French	4.5
maître ni serviteur	French	4.5
il n'y a	English	English
que des soldats	English	English
te disje et	French	4.5
contemoi ton histoire	English	English
M d'Assonville n'était	French	4.5
déjà plus le	French	4.5
brillant officier dont	French	4.5
les yeux lançaient	French	4.5
des éclairs au	French	4.5
moment de la	French	4.5
bataille la tristesse	French	2.5
était revenue à	French	2.5
son front et	French	4.5
la pâleur à	French	2.5
ses joues où	French	4.5
la ligne aiguë	French	4.5
de ses moustaches	English	English
se dessinait comme	French	4.5
un coup de	French	4.5
pinceau sur de	French	4.5
l'albâtre à l'ardeur	French	4.5
généreuse à la	French	4.5
mâle fierté à	French	2.5
l'impatience téméraire dont	French	4.5
les flammes coloraient	French	4.5
tout à l'heure	French	4.5
son beau visage	French	0.5
un doux et	French	4.5
mélancolique sourire avait	French	4.5
succédé se sentait	French	4.5
tout à la	French	4.5
fois ému et	French	4.5
attiré par cette	French	4.5
tristesse mystérieuse dont	French	4.5
la source devait	French	4.5
sourdre au fond	French	2.5
du coeur s'assit	English	English
et raconta la	French	4.5
naïve histoire de	French	4.5
sa jeunesse de	French	4.5
ses amours de	French	4.5
son départ d'Assonville	English	English
l'écoutait un instant	French	2.5
ses yeux s'humectèrent	French	4.5
au récit des	French	4.5
amours innocentes de	French	4.5
Jacques mais cet	French	4.5
instant fut si	French	4.5
court que ne	French	4.5
vit pas même	French	4.5
briller sa prunelle	French	1.4999999999999998
humide d'Assonville porta	French	1.5
le verre à	French	2.5
sa bouche Je	French	4.5
bois à tes	English	English
espérances ditil Jacques	English	English
soupira C'est la	French	4.5
fortune du pauvre	French	4.5
murmuratil ton amante	English	English
a le coeur	English	English
honnête et sincère	French	4.5
gardeles mais si	French	4.5
elle est faible	French	4.5
comme le roseau	French	1.5
ou trompeuse comme	French	4.5
le vent chasseles	English	English
hardiment espérances trahies	French	2.5
sont comme des	French	4.5
épines qui déchirent	French	4.5
J'espère parce que	French	4.5
je crois répondit	French	4.5
Tu as dixhuit	French	2.5
ans s'écria d'Assonville	English	English
Et un éclair	French	4.5
d'ironie amère passa	French	0.5
dans ses yeux	French	4.5
puis il reprit	English	English
tout doucement Crois	French	4.5
la croyance est	French	4.5
le parfum de	French	4.5
la vie et	French	4.5
la parure de	French	4.5
la jeunesse malheur	French	4.5
à ceux qui	French	4.5
n'ont pas cru	English	English
ceuxlà n'ont pas	French	4.5
aimé ceuxlà mourront	English	English
sans avoir vécu	French	4.5
M d'Assonville pressa	French	4.5
les deux mains	French	4.5
de le reflet	English	English
d'une passion mal	English	English
éteinte illumina son	French	4.5
visage et il	French	2.5
avala son verre	English	English
tout d'un trait	French	4.5
A quoi pensaisje	French	4.5
repritil il s'agit	French	4.5
d'amour et point	English	English
de philosophie que	French	4.5
comptestu faire Je	French	4.5
vous l'ai dit	French	1.5
me rendre à	French	2.5
et chercher fortune	English	English
à moins que	French	4.5
vous ne consentiez	French	0.5
à me garder	English	English
avec vous C'est	French	4.5
ce que nous	French	4.5
examinerons plus tard	English	English
et ce à	French	2.5
quoi je consentirais	French	4.5
volontiers si ma	French	4.5
compagnie pouvait te	French	2.5
rendre service supposons	English	English
un instant que	French	4.5
tu sois arrivé	French	0.5
à qu'y ferastu	English	English
Franchement je n'en	French	4.5
sais rien je	French	4.5
frapperai à toutes	French	2.5
les portes C'est	French	4.5
un excellent moyen	French	4.5
pour n'entrer nulle	English	English
part quelque argent	English	English
Oui cinquante livres	French	4.5
qu'on m'a volées	French	4.5
et que j'espère	French	4.5
bien rattraper avec	French	2.5
ma valise Et	French	4.5
quinze louis que	French	4.5
je te donnerai	French	4.5
pour ta part	French	0.5
du butin Eh	French	2.5
mais ça fait	French	4.5
Ça fait quinze	English	English
louis guerre comme	French	4.5
en amour ce	French	4.5
qu'on perd est	French	4.5
perdu Ah Avec	French	2.5
trois cent soixante	French	4.5
livres tu as	English	English
juste de quoi	French	4.5
battre le pavé	French	0.5
de Paris pendant	French	4.5
deux mois après	French	4.5
quoi tu auras	French	1.5
la ressource de	French	4.5
te faire laquais	French	4.5
J'aimerais mieux me	French	4.5
jeter dans la	French	4.5
rivière Ce n'est	French	4.5
pas le moyen	French	4.5
d'épouser de C'est	French	4.5
juste puis toujours	French	4.5
bien me faire	French	4.5
soldat Ceci est	French	4.5
une autre affaire	French	4.5
le métier des	French	4.5
armes tu as	English	English
vingt chances de	French	4.5
te faire casser	French	2.5
la tête et	French	4.5
une de gagner	French	4.5
des épaulettes C'est	French	4.5
peu Mais à	French	2.5
sur deux chances	French	0.5
de faire fortune	English	English
tu en as	English	English
douze de mourir	French	0.5
de faim à	French	2.5
moins de consentir	French	4.5
à faire certains	French	0.5
métiers qui répugnent	French	4.5
aux honnêtes gens	English	English
Le peu de	French	4.5
tout à l'heure	French	4.5
se réduit maintenant	French	4.5
à rien Ah	English	English
mon ami tu	English	English
t'es chargé d'une	French	4.5
rude entreprise dans	French	4.5
laquelle le courage	English	English
et la persévérance	French	4.5
ne peuvent quelque	French	4.5
chose que dans	French	4.5
le cas où	French	4.5
le hasard se	French	2.5
met de leur	French	4.5
côté En attendant	French	4.5
qu'il y consente	French	4.5
que me conseillezvous	French	4.5
C'est ce que	French	4.5
nous allons décider	French	4.5
ensemble cette bouteille	English	English
de vieux vin	English	English
de vin porte	French	4.5
conseil il montre	French	4.5
faciles les choses	French	0.5
les plus extravagantes	English	English
et il n'y	English	English
a guère que	French	4.5
celleslà qui vaillent	French	4.5
la peine d'être	French	4.5
tentées on veut	French	4.5
devenir capitaine il	French	2.5
faut songer à	French	2.5
devenir général Général	French	4.5
s'écria tout étourdi	French	4.5
Certes si j'étais	French	4.5
assez fou pour	French	4.5
goûter à l'amour	English	English
je me risquerais	French	4.5
aux princesses du	French	4.5
sang Eh bien	French	4.5
pour commencer si	French	4.5
vous m'incorporiez aux	French	4.5
chevaulégers qu'en ditesvous	French	4.5
Eh l'uniforme est	French	4.5
joli tu as	English	English
grand soin d'éviter	French	4.5
la mitraille les	French	4.5
balles les boulets	English	English
les grenades et	French	4.5
autres projectiles fâcheux	French	4.5
si tu n'es	French	4.5
ni tué ni	French	4.5
amputé si tu	English	English
te conduis toujours	French	4.5
vaillamment si tu	English	English
ne te fais	French	4.5
jamais punir si	French	4.5
tu te signales	French	4.5
par quelque action	French	2.5
d'éclat et si	French	4.5
le bonheur te	French	2.5
sourit tu peux	French	4.5
compter sur les	French	4.5
galons de maréchal	French	4.5
des logis à	French	2.5
quarantehuit ans ne	French	4.5
faudrait pas cependant	French	4.5
qu'un lieutenant s'avisât	French	4.5
de te regarder	English	English
de travers parce	French	4.5
que tu aurais	French	4.5
manqué de le	French	4.5
saluer à propos	French	4.5
auquel cas tu	English	English
courrais le risque	French	4.5
de rester brigadier	English	English
jusqu'à la soixantaine	French	4.5
Jacques laissa tomber	English	English
son verre Ce	French	4.5
n'est ni toi	French	4.5
ni moi qui	French	4.5
avons fait le	French	4.5
monde comme il	French	2.5
est et ce	French	4.5
n'est pas ta	English	English
faute si ton	English	English
père n'était pas	French	4.5
chevalier tout au	French	4.5
moins père prudent	English	English
au temps où	French	4.5
nous sommes devrait	French	4.5
toujours naître comte	English	English
ou baron Monsieur	French	4.5
je cours à	French	2.5
tout de ce	French	4.5
pas s'écria effaré	French	4.5
A eh eh	French	2.5
c'est une ville	French	0.5
aimable aux jeunes	French	4.5
gens riches et	French	4.5
de bonne mine	French	2.5
mais quand on	English	English
n'a que de	French	4.5
la bonne mine	French	2.5
il faut bien	French	4.5
prendre garde d'entrer	French	4.5
au cabaret gentilshommes	English	English
en sortent gris	French	4.5
les pauvres diables	English	English
en sortent racolés	French	4.5
est un endroit	French	4.5
où les plaisirs	English	English
abondent seulement ils	French	2.5
coûtent très cher	English	English
surtout ceux qui	French	4.5
ne coûtent rien	French	4.5
est vrai que	French	4.5
lorsqu'on est beau	French	2.5
garçon on a	English	English
une chance nouvelle	French	4.5
foi oui diable	English	English
avaisje l'esprit de	French	4.5
n'y pas penser	French	0.5
On peut plaire	French	4.5
à quelque douairière	French	4.5
qui vous place	English	English
alors dans ses	French	4.5
affections juste entre	French	4.5
son épagneul et	French	4.5
son confesseur le	French	4.5
matin on sort	French	4.5
de son appartement	English	English
par la porte	French	4.5
secrète bout d'un	French	4.5
mois on est	French	4.5
le commensal de	French	4.5
la maison en	French	4.5
qualité de secrétaire	French	4.5
on a le	French	4.5
teint fleuri la	French	4.5
bouche vermeille et	French	4.5
l'on a tout	French	2.5
le jour pour	French	4.5
se reposer Jacques	English	English
fit un geste	French	4.5
de dégoût Non	French	4.5
alors il nous	French	4.5
reste l'espoir de	French	4.5
devenir intendant métier	French	4.5
Saistu voler Jacques	English	English
pâlit et se	French	2.5
leva Monsieur ditil	French	4.5
d'une voix étranglée	French	4.5
par l'émotion M	French	0.5
d'Assonville le regarda	English	English
sans qu'un muscle	English	English
de son visage	French	0.5
tressaillît Jacques passa	French	0.5
ses mains dans	French	4.5
les longues boucles	English	English
de ses cheveux	French	4.5
blonds Un soupir	French	1.5
profond sortit de	French	4.5
sa poitrine et	French	4.5
il se rassit	English	English
Pardonnezmoi monsieur le	French	4.5
comte repritil je	French	4.5
ne m'attendais pas	French	4.5
à cet outrage	French	0.5
de vous qui	French	4.5
avez dormi dans	French	4.5
les bras de	French	4.5
mon père avez	French	4.5
voulu sans doute	French	4.5
me punir d'avoir	French	4.5
si promptement oublié	French	0.5
la distance qui	French	4.5
existe entre nous	French	4.5
mais vous l'avez	French	4.5
fait méchamment monsieur	French	4.5
le comte Vous	French	4.5
n'avez pas le	French	4.5
désir de me	French	4.5
venir en aide	French	4.5
je le vois	French	4.5
bien prendrai donc	French	4.5
conseil des circonstances	English	English
mais quoi qu'il	French	4.5
puisse advenir et	French	4.5
dans quelque situation	English	English
que je me	French	4.5
trouve croyezle bien	French	4.5
jamais je n'oublierai	French	4.5
que j'ai pour	French	4.5
me juger mon	French	4.5
làhaut et mon	French	4.5
père làbas Tu	English	English
es un brave	English	English
et loyal garçon	French	4.5
mon ami et	French	4.5
je suis fier	French	0.5
de presser ta	English	English
main répondit d'Assonville	English	English
j'ai voulu t'éprouver	French	4.5
et maintenant que	French	4.5
je sais ton	English	English
âme aussi ferme	French	2.5
que ton bras	English	English
est fort je	French	4.5
te parlerai en	French	4.5
homme n'as rien	French	4.5
à faire dans	French	4.5
les chevaulégers Seraistu	French	1.5
le plus instruit	English	English
le plus hardi	English	English
et le plus	French	4.5
intelligent soldat de	French	4.5
la compagnie le	French	4.5
plus mince cadet	French	1.5
de famille expédié	French	4.5
de par la	French	4.5
cour te passerait	French	4.5
sur le corps	English	English
n'as rien à	French	2.5
faire non plus	French	4.5
à Avec une	French	4.5
conscience trempée comme	French	4.5
l'acier on n'arrive	English	English
à rien à	French	2.5
moins d'être duc	French	4.5
et pair tout	French	2.5
au moins soldat	English	English
les soldats peuvent	French	4.5
garder l'honneur pur	English	English
mais entre dans	French	4.5
l'artillerie seulement un	French	4.5
homme qui a	English	English
de la vaillance	English	English
de la conduite	French	4.5
et quelque savoir	French	4.5
peut se pousser	French	0.5
ne fûtil pas	French	4.5
gentilhomme as de	French	4.5
la jeunesse et	French	4.5
une tournure qui	French	4.5
valent bien quelque	French	4.5
chose fera le	French	4.5
reste il y	French	0.5
a mille hasards	English	English
entre toi et	French	4.5
le but mais	French	4.5
est au bout	English	English
du chemin un	French	4.5
frère qui commande	French	4.5
une compagnie de	French	4.5
sapeurs à je	French	4.5
te donnerai une	French	4.5
lettre pour lui	French	4.5
un autre moimême	French	4.5
le fils de	French	4.5
ne sortira pas	French	4.5
de la famille	English	English
Jacques prit les	French	4.5
mains de d'Assonville	English	English
et les baisa	French	4.5
sans pouvoir parler	French	4.5
lendemain portant dans	French	4.5
une bourse les	French	4.5
quinze louis d'or	English	English
que lui avait	French	4.5
donnés le capitaine	French	0.5
et monté sur	French	4.5
un bon cheval	English	English
bien équipé il	French	2.5
quitta l'abbaye Voici	French	4.5
la lettre lui	French	4.5
dit d'Assonville si	French	4.5
tu as quelque	French	4.5
regret de me	French	4.5
quitter j'en ai	French	4.5
tout autant de	French	4.5
te perdre mais	French	4.5
il faut que	French	4.5
tu arrives à	French	2.5
et le plus	French	4.5
court chemin passe	French	4.5
par donc à	French	2.5
jamais tu as	English	English
besoin de moi	French	4.5
tu me trouveras	French	4.5
mon ami Jacques	English	English
pressa la main	French	1.5
du capitaine et	French	4.5
piqua des deux	French	4.5
pour ne pas	French	4.5
lui laisser voir	French	4.5
que ses yeux	French	4.5
se remplissaient de	French	4.5
larmes avait déjà	French	4.5
l'orgueil du soldat	English	English
V UN Jacques	English	English
arriva sans encombre	French	4.5
à premier soldat	English	English
qu'il rencontra lui	French	4.5
indiqua la demeure	French	4.5
de de peine	French	2.5
le capitaine eutil	French	0.5
reconnu l'écriture de	French	4.5
son frère qu'il	French	4.5
donna l'ordre d'introduire	French	4.5
le voyageur de	French	4.5
était un homme	French	4.5
de grande taille	French	4.5
sec nerveux ses	French	4.5
yeux gris enfoncés	French	4.5
sous d'épais sourcils	French	0.5
bruns séparés à	French	2.5
leur pointe interne	French	2.5
par une ride	French	0.5
profonde brillaient d'un	French	4.5
feu extraordinaire une	French	4.5
longue moustache fauve	French	4.5
coupait en deux	French	4.5
son visage amaigri	French	1.5000000000000002
par les fatigues	French	1.5
de la guerre	English	English
il avait en	French	4.5
parlant l'habitude d'en	English	English
tordre la pointe	French	1.5
aiguë entre ses	French	4.5
doigts sans quitter	English	English
du regard la	French	4.5
personne qu'il interrogeait	English	English
regard net et	French	4.5
vif comme une	French	4.5
pointe d'acier semblait	French	1.5
descendre jusqu'au fond	French	2.5
des consciences et	French	4.5
les plus endurcies	English	English
se sentaient troublées	French	4.5
par sa fixité	French	4.5
de avait deux	French	4.5
ou trois ans	English	English
de moins que	French	4.5
son frère et	French	4.5
paraissait être son	French	4.5
aîné de trois	French	4.5
ou quatre du	French	4.5
commandement et surtout	French	2.5
son caractère naturellement	French	4.5
impérieux donnaient à	French	2.5
toute sa personne	French	4.5
un air d'autorité	French	4.5
qui imposait au	French	4.5
premier coup d'oeil	English	English
fallait s'arrêter aux	French	4.5
traits du visage	French	0.5
pour trouver quelque	French	4.5
ressemblance entre les	French	4.5
deux frères n'y	English	English
en avait aucune	French	4.5
dans les physionomies	English	English
de tenait la	French	4.5
lettre de d'Assonville	English	English
à la main	French	1.5
lorsque entra le	French	4.5
considéra deux ou	French	4.5
trois minutes en	French	4.5
silence Tu arrives	English	English
de dit enfin	French	4.5
le capitaine Il	French	2.5
y a juste	French	1.5
un quart d'heure	French	4.5
D'après ce que	French	4.5
mon frère me	French	4.5
marque tu as	English	English
l'intention de te	French	2.5
faire soldat Oui	French	4.5
capitaine C'est un	French	4.5
métier où il	French	2.5
y a plus	French	4.5
de plomb que	French	4.5
d'argent à gagner	French	4.5
C'est aussi le	French	4.5
plus honorable pour	French	4.5
un homme de	French	4.5
coeur qui veut	French	4.5
se pousser dans	French	4.5
le monde Ça	French	4.5
te regarde mais	French	4.5
je dois te	French	2.5
prévenir que dans	French	4.5
l'artillerie et dans	French	4.5
ma compagnie surtout	French	2.5
on est esclave	English	English
de la discipline	English	English
la première faute	French	4.5
on met le	French	4.5
maladroit au cachot	English	English
à la seconde	French	2.5
on le fait	French	4.5
passer par les	French	4.5
verges à la	French	4.5
troisième on le	French	4.5
fusille Je tâcherai	French	4.5
de ne pas	French	4.5
aller jusqu'au cachot	English	English
afin d'être toujours	French	4.5
loin du mousquet	English	English
C'est ton affaire	French	4.5
connais le régime	French	4.5
de ma compagnie	French	0.5
te plaîtil toujours	French	4.5
d'y entrer Oui	French	4.5
capitaine M d'Assonville	English	English
me parle de	French	4.5
toi comme d'un	French	4.5
garçon déterminé as	English	English
vu le feu	French	4.5
ditil et tu	English	English
t'y es bien	French	4.5
conduit J'ai fait	French	4.5
mon devoir C'est	French	4.5
bien partir d'aujourd'hui	French	4.5
tu es soldat	English	English
dans ma compagnie	French	0.5
souvienstoi de suivre	French	4.5
toujours la ligne	French	4.5
droite et ne	French	4.5
m'oblige pas à	French	2.5
te punir je	French	4.5
le ferai sans	French	4.5
pitié d'autant plus	French	4.5
que m'étant recommandé	French	0.5
par mon frère	French	4.5
je veux que	French	4.5
tu sois digne	English	English
de sa protection	French	1.5
nom de ton	English	English
père m'engage d'ailleurs	French	4.5
à redoubler de	French	4.5
sévérité à ton	English	English
égard je prétends	French	4.5
lui prouver que	French	4.5
tu mérites d'être	French	4.5
son fils Jacques	English	English
s'apprêtait à répondre	French	4.5
de l'arrêta d'un	French	4.5
geste Tu t'appelles	French	2.5
continuatil Oui capitaine	French	0.5
C'est un nom	English	English
de bourgeois il	French	2.5
n'en faut pas	French	4.5
au régiment t'appelleras	English	English
Comme vous voudrez	French	4.5
Parbleu c'est bien	French	4.5
ainsi que je	French	4.5
l'entends les soldats	English	English
ont un nom	English	English
Oui un nom	English	English
qui n'est pas	French	4.5
le leur Mais	French	4.5
c'est le mien	French	4.5
par hasard que	French	4.5
j'aie besoin de	French	4.5
leur consentement pour	French	4.5
les baptiser Estce	English	English
encore de la	French	4.5
discipline demanda en	French	4.5
rougissant Oui mon	French	4.5
garçon répondit de	French	4.5
qui ne put	English	English
s'empêcher de sourire	French	4.5
mordieu je le	French	4.5
tiens ton nom	English	English
il est écrit	French	0.5
sur ton visage	French	0.5
Ah je m'appelle	French	1.5
BelleRose M de	French	4.5
agita sa sonnette	French	1.5
un soldat de	French	4.5
planton dans l'antichambre	French	1.5
entra le capitaine	French	0.5
lui dit quelques	French	4.5
mots à l'oreille	French	1.5
le soldat sortit	French	0.5
et revint cinq	French	0.5
minutes après avec	French	2.5
un caporal de	French	4.5
sapeurs Monsieur de	French	4.5
la dit de	French	4.5
au sousofficier voilà	French	4.5
une recrue que	French	4.5
je vous confie	French	4.5
vous le mènerez	French	4.5
à la chambrée	French	4.5
l'instruirez dans le	French	4.5
métier et me	French	4.5
rendrez compte de	French	4.5
sa conduite Malgré	French	4.5
son nom formidable	English	English
le caporal la	French	4.5
était un excellent	English	English
homme qui ne	French	4.5
demandait pas mieux	French	4.5
que de rendre	French	2.5
service aux gens	English	English
ils furent tous	French	2.5
deux dans la	French	4.5
rue le caporal	English	English
et la recrue	English	English
la se tourna	English	English
vers notre ami	English	English
appelé maintenant Il	French	2.5
paraît que vous	French	4.5
avez été chaudement	French	1.5
recommandé au capitaine	French	0.5
lui ditil il	French	2.5
ne m'en a	English	English
jamais dit si	French	4.5
long à propos	French	4.5
d'un soldat Si	French	4.5
long un pauvre	French	4.5
bout de phrase	English	English
d'une douzaine de	French	4.5
mots Eh c'est	French	4.5
tout juste trois	French	4.5
fois de plus	French	4.5
qu'il n'a coutume	English	English
d'en débiter une	French	4.5
recrue arrive à	French	2.5
la compagnie de	French	4.5
l'interroge puis il	French	2.5
fait appeler un	French	4.5
caporal et lui	French	4.5
montrant l'homme il	French	2.5
lui dit un	French	4.5
soldat inscrivezle et	French	4.5
il tourne le	French	4.5
dos c'est un	French	4.5
terrible homme que	French	4.5
le capitaine Bah	French	2.5
dit je l'ai	French	4.5
vu sourire Il	French	2.5
a souri Mais	French	4.5
comme tout le	French	4.5
monde ne lui	French	4.5
arrive donc jamais	French	1.5
Si quelquefois mais	French	4.5
pas souvent qui	French	4.5
suis vieux dans	French	4.5
la compagnie je	French	4.5
sais qu'il a	English	English
le coeur meilleur	French	4.5
que le visage	French	0.5
mais il a	English	English
pour les recrues	English	English
un diable d'air	French	0.5
qui épouvante les	French	4.5
plus têtus vous	French	4.5
veut du bien	French	4.5
vous arriverez vite	French	0.5
à l'épaulette L'avancement	French	4.5
est donc rapide	French	4.5
chez vous Ça	French	4.5
dépend les sièges	French	4.5
tuent beaucoup d'officiers	French	2.5
il faut bien	French	4.5
les remplacer alors	French	2.5
on choisit parmi	English	English
les cadets pointeurs	French	4.5
ou parmi les	French	4.5
soldats les plus	French	4.5
habiles et les	French	4.5
plus vaillants Si	French	4.5
bien que pour	French	4.5
ramasser des épaulettes	French	0.5
il faut que	French	4.5
l'ennemi nous jette	French	4.5
des boulets Il	French	2.5
ne s'en fait	French	4.5
pas faute Ces	French	4.5
bons Oh notre	French	4.5
commandant leur doit	French	4.5
son grade atil	French	2.5
juré de brûler	French	4.5
un cierge en	French	4.5
leur honneur au	French	4.5
beau milieu de	French	4.5
qui est à	French	2.5
la tête du	French	4.5
bataillon est entré	French	4.5
sapeur comme vous	French	4.5
a vu passer	French	4.5
dix capitaines et	French	4.5
trois commandants ç'a	French	4.5
été l'affaire de	French	4.5
trois ou quatre	French	0.5
boulets et d'une	French	4.5
demidouzaine de grenades	English	English
Ma foi le	French	4.5
métier de sapeur	French	1.5
est un beau	French	2.5
métier Très beau	French	2.5
pour un officier	English	English
qui perd la	French	4.5
jambe trente soldats	English	English
perdent la tête	French	4.5
Ah C'est un	French	4.5
calcul que je	French	4.5
me suis amusé	French	4.5
à chiffrer dans	French	4.5
mes heures de	French	4.5
loisir en pourrez	French	4.5
faire la preuve	French	4.5
à la première	French	4.5
rencontre BelleRose ne	French	4.5
dit mot et	French	4.5
se gratta l'oreille	French	1.5
au bout de	French	4.5
la rue il	French	2.5
se tourna vers	English	English
le caporal Monsieur	French	4.5
de la ditil	French	4.5
me permettezvous de	French	4.5
vous adresser une	French	4.5
question Deux si	French	4.5
vous voulez Vous	French	4.5
m'avez dit je	French	4.5
crois que dans	French	4.5
l'artillerie on avance	French	4.5
ou on meurt	French	0.5
Oui mon camarade	English	English
la mitraille sert	English	English
d'éclaireur Depuis combien	French	1.5
de temps servezvous	French	4.5
Depuis huit ans	English	English
Diable Voilà une	French	4.5
exclamation qui me	French	4.5
prouve que votre	French	4.5
esprit vient de	French	4.5
se livrer à	French	2.5
une opération d'arithmétique	French	4.5
le sapeur la	French	4.5
a mis huit	French	4.5
ans à devenir	French	4.5
caporal combien le	French	4.5
sapeur en mettratil	French	4.5
pour devenir capitaine	French	0.5
ce que nous	French	4.5
appelons une règle	French	4.5
de trois Aije	French	4.5
deviné Parfaitement Ici	French	2.5
la règle de	French	4.5
trois a tort	English	English
ne mettrez peutêtre	French	4.5
que six mois	French	4.5
à monter au	French	4.5
grade de sergent	French	0.5
à moi je	French	4.5
mourrai caporal tient	French	4.5
à une circonstance	English	English
particulière été piqueur	French	4.5
or un de	French	4.5
nos jeunes officiers	English	English
de qui m'avait	French	4.5
vu sous la	French	4.5
livrée m'a reconnu	French	4.5
On ne fait	French	4.5
pas un officier	English	English
d'un piqueur grâce	French	4.5
à la protection	French	1.5
de de j'arrive	French	0.5
à la hallebarde	English	English
j'y resterai La	French	4.5
fit cet aveu	French	4.5
d'un air simple	French	1.5
et résigné qui	French	4.5
toucha BelleRose soldat	English	English
prit la main	French	1.5
du caporal et	French	4.5
la lui serra	French	0.5
puis tous deux	French	4.5
arrivèrent à la	French	4.5
caserne chambrée où	French	4.5
fut incorporé se	French	2.5
composait de huit	French	4.5
hommes tous soumis	English	English
à une sévère	French	4.5
discipline donna au	French	4.5
nouveau venu un	French	4.5
habit d'uniforme un	French	4.5
fusil un sabre	French	1.5
un poignard et	French	4.5
une paire de	French	4.5
pistolets et bien	French	4.5
équipé monta sa	French	4.5
première garde lendemain	English	English
on lui apprit	English	English
le maniement des	French	4.5
armes bout d'un	French	4.5
quart d'heure le	French	4.5
caporal s'aperçut que	French	4.5
sous ce rapportlà	French	4.5
la recrue donnerait	French	4.5
des leçons à	French	2.5
l'instructeur surlendemain on	English	English
le mit aux	French	4.5
premiers éléments du	French	4.5
calcul sauta pardessus	French	4.5
les quatre règles	French	4.5
et arriva tout	French	2.5
d'un coup dans	French	4.5
des régions où	French	4.5
chaque chiffre était	French	4.5
une lettre répondait	French	4.5
aux problèmes par	French	4.5
des équations jour	French	4.5
suivant le caporal	English	English
lui mit un	French	4.5
crayon entre les	French	4.5
doigts qu'il lui	French	4.5
enseignait les principes	French	4.5
du dessin linéaire	French	4.5
s'évertuant à lui	French	4.5
démontrer la différence	French	4.5
qui sépare un	French	4.5
parallélogramme d'un trapèze	French	4.5
barbouillait un bout	English	English
de papier sur	French	4.5
le coin de	French	4.5
la table la	French	4.5
démonstration fut terminée	French	4.5
le barbouillage était	French	4.5
fini et le	French	4.5
caporal rit de	French	4.5
bon coeur en	French	4.5
reconnaissant les mèches	French	4.5
de ses cheveux	French	4.5
plats collés sur	French	4.5
ses tempes avec	French	2.5
son nez retroussé	French	0.5
entre deux yeux	French	4.5
fendus à la	French	4.5
chinoise Ah çà	French	4.5
vous êtes fils	English	English
de prince s'écria	French	4.5
le caporal en	French	4.5
jetant son crayon	English	English
J'ai toujours tenu	French	4.5
ma pauvre mère	French	4.5
pour une très	French	4.5
honnête femme et	French	4.5
mon père était	French	4.5
fauconnier Le pauvre	French	4.5
la avait étudié	French	4.5
sous le sergent	French	0.5
instructeur et un	French	4.5
peu au hasard	English	English
comme il avait	French	4.5
pu mais la	French	4.5
ne savait que	French	4.5
tout juste ce	French	4.5
qu'il fallait pour	French	4.5
être caporal de	French	4.5
sapeurs la était	French	4.5
embarrassé il commençait	French	4.5
par réfléchir mais	French	4.5
quand l'embarras était	French	4.5
extrême il finissait	French	4.5
par se rendre	French	2.5
chez son capitaine	French	0.5
cette circonstance il	French	2.5
se rendit tout	French	2.5
droit chez de	French	4.5
sautant pardessus la	French	4.5
réflexion cas était	French	4.5
grave Capitaine vous	French	4.5
avez mis un	French	4.5
ingénieur dans la	French	4.5
chambrée lui ditil	French	4.5
vous m'aviez chargé	French	4.5
d'instruire et c'est	French	4.5
qui instruit son	French	4.5
caporal fautil faire	French	4.5
Envoyezmoi Après un	French	4.5
court entretien de	French	4.5
engagea le protégé	French	4.5
de son frère	French	4.5
à continuer ses	French	4.5
études en mathématiques	French	4.5
et à y	French	0.5
joindre l'étude des	French	4.5
langues Nous sommes	French	4.5
tous plus ou	French	4.5
moins ingénieurs et	French	4.5
canonniers lui ditil	French	4.5
quand tu sauras	French	1.5
bien la trigonométrie	French	4.5
et l'espagnol tu	English	English
ne seras pas	French	4.5
loin de l'épaulette	French	4.5
commenceras les leçons	French	4.5
demain Quatre ou	French	4.5
cinq jours après	French	4.5
reçut une lettre	French	1.5
de d'Assonville qui	French	4.5
tout en le	French	4.5
félicitant de son	French	4.5
zèle lui envoyait	French	1.4999999999999998
quinze louis pour	French	4.5
payer ses professeurs	English	English
Tout de suite	French	4.5
et tout ému	French	4.5
de joie il	French	2.5
courut la montrer	French	4.5
à de Nancrais	French	4.5
de fronça le	French	4.5
sourcil Je voudrais	French	4.5
bien savoir s'écriatil	French	4.5
en tordant sa	French	4.5
moustache si vous	French	4.5
êtes sapeur ou	French	4.5
chevauléger ne me	French	4.5
mêle point des	French	4.5
affaires de la	French	4.5
cavalerie et n'entends	French	0.5
point qu'on se	French	2.5
mêle de celles	French	4.5
de l'artillerie Mais	French	4.5
Paix êtes soldat	English	English
dans ma compagnie	French	0.5
si je trouve	French	4.5
bon de vous	French	4.5
donner des maîtres	French	4.5
c'est qu'apparemment il	French	2.5
me plaît de	French	4.5
les payer M	French	0.5
d'Assonville vous a	English	English
envoyé quinze louis	French	0.5
c'est bien je	French	4.5
ne les lui	French	4.5
renverrai pas parce	French	4.5
que c'est mon	French	4.5
frère mais tu	English	English
me feras le	French	4.5
plaisir de prendre	French	4.5
cette bourse et	French	4.5
de payer tes	English	English
leçons avec l'or	French	1.5
que j'ai mis	French	4.5
dedans sinon tu	English	English
en auras pour	French	4.5
dix jours de	French	4.5
salle de police	French	0.5
maintenant Oh le	French	4.5
terrible capitaine disait	French	0.5
tout en riant	French	0.5
qu'il est bon	English	English
et qu'il se	French	2.5
donne du mal	English	English
pour paraître méchant	French	4.5
Ce jourlà étudia	French	4.5
la théorie du	French	4.5
carré de l'hypoténuse	French	1.5
et prit sur	French	4.5
le papier un	French	4.5
vigoureux bastion défendu	French	4.5
par une lunette	French	1.5
Quelquefois l'image de	French	4.5
venait embrouiller les	French	4.5
angles et le	French	4.5
souvenir des promenades	English	English
dans le jardin	French	0.5
faisait manquer l'effet	French	1.5
d'un chemin couvert	French	4.5
mais rattrapait le	French	4.5
calcul et le	French	4.5
siège en se	French	2.5
disant que chaque	French	4.5
chiffre et chaque	French	4.5
assaut le rapprochaient	French	4.5
de son amante	English	English
beau jour vers	English	English
midi comme il	French	2.5
sortait de sa	French	4.5
chambrette mêlant dans	French	4.5
son esprit l'amour	English	English
aux mathématiques un	French	4.5
soldat le heurta	French	4.5
vivement dans l'escalier	English	English
Au diable le	French	4.5
maladroit s'écria le	French	4.5
soldat Il me	French	4.5
semble que c'est	French	4.5
vous qui m'avez	French	4.5
poussé dit je	French	4.5
passais à droite	French	4.5
vous montiez à	French	2.5
gauche et vous	French	4.5
vous êtes jeté	French	4.5
sur moi Lequel	French	4.5
est le maladroit	French	4.5
s'il vous plaît	French	4.5
Tiens je crois	French	4.5
qu'il raisonne de	French	4.5
me contredire par	French	4.5
hasard mauvais blancbec	English	English
En effet j'ai	French	4.5
eu tort ce	French	4.5
n'est pas maladroit	French	4.5
que j'aurais dû	French	4.5
dire c'est insolent	French	0.5
Le soldat leva	French	0.5
la main mais	French	4.5
la saisit en	French	4.5
l'air et sautant	English	English
à la gorge	English	English
de son adversaire	English	English
il le précipita	French	4.5
rudement sur l'escalier	English	English
bruit de cette	French	4.5
lutte quelques sapeurs	French	1.5
accoururent et voyant	French	1.5
ce qui se	French	2.5
passait s'élancèrent sur	French	4.5
les combattants pour	French	4.5
les séparer était	French	4.5
temps avait appuyé	French	4.5
un genou sur	French	4.5
la poitrine du	French	4.5
soldat qui râlait	French	4.5
sous son étreinte	French	4.5
furieuse Tu vas	English	English
me suivre un	French	4.5
homme qui a	English	English
la main si	French	4.5
forte doit savoir	French	4.5
tenir une épée	French	4.5
dit le soldat	English	English
après qu'il se	French	2.5
fut relevé Pour	French	4.5
toute réponse lui	French	4.5
fit signe de	French	4.5
marcher sortit de	French	4.5
la ville sans	French	4.5
bruit et on	English	English
s'arrêta dans la	French	4.5
campagne derrière un	French	4.5
vieux cimetière où	French	4.5
personne ne passait	French	4.5
adversaires mirent habit	English	English
bas et tirant	French	0.5
l'épée commencèrent à	French	2.5
ferrailler soldat qui	French	4.5
était un canonnier	French	1.5
du nom de	French	4.5
poussa avec tant	French	2.5
de furie que	French	4.5
celuici fut contraint	French	4.5
de rompre deux	French	4.5
fois Oh oh	French	2.5
s'écria son ennemi	French	1.5
il paraît que	French	4.5
ce que tu	English	English
as le mieux	French	4.5
retenu de tes	English	English
études c'est l'art	French	1.5
de battre en	French	4.5
retraite BelleRose ne	French	4.5
répondit pas et	French	4.5
continua de parer	French	0.5
tentait n'ayant plus	French	4.5
de colère au	French	4.5
fond du coeur	English	English
de désarmer mais	French	4.5
le canonnier avait	French	4.5
trop d'adresse pour	French	4.5
le lui permettre	French	4.5
rompant une troisième	French	4.5
fois trébucha contre	French	4.5
une pierre profita	English	English
de l'accident pour	French	4.5
lui porter une	French	4.5
botte qui l'aurait	French	4.5
percé d'outre en	French	4.5
outre si le	French	4.5
sapeur revenant vivement	French	1.5
à la parade	English	English
n'avait écarté le	French	4.5
coup l'épée glissa	French	1.5
le long du	French	4.5
corps et déchira	French	4.5
la chemise qui	French	4.5
se rougit de	French	4.5
quelques gouttes de	French	4.5
sang péril rendit	English	English
un peu de	French	4.5
son courroux à	French	2.5
il se mit	English	English
à son tour	French	2.5
à presser qui	French	4.5
rompit mais point	English	English
assez vite pour	French	4.5
éviter un coup	English	English
de pointe dans	French	4.5
les chairs du	French	4.5
bras avança toujours	French	4.5
un second coup	English	English
blessa le canonnier	French	1.5
à l'épaule il	French	2.5
voulut riposter mais	French	4.5
une troisième fois	French	4.5
l'épée du sapeur	French	1.5
l'atteignit à la	French	4.5
poitrine chancela et	French	4.5
tomba sur ses	French	4.5
genoux J'ai mon	French	4.5
compte camarade ditil	French	4.5
et il s'évanouit	French	4.5
BelleRose rentré au	French	4.5
quartier raconta ce	French	4.5
qui venait de	French	4.5
se passer à	French	2.5
la Déroute C'est	French	4.5
fâcheux lui dit	French	1.5
le caporal mais	French	4.5
c'était inévitable BelleRose	English	English
le regarda Oh	French	2.5
reprit le caporal	English	English
ceci est dans	French	4.5
les moeurs du	French	4.5
régiment a voulu	French	1.5
vous tâter est	French	4.5
un tâteur une	French	4.5
recrue arrive au	French	4.5
corps un soldat	English	English
le provoque tout	French	2.5
sert de prétexte	French	4.5
en pareille circonstance	English	English
il lui donne	French	4.5
ou il en	French	4.5
reçoit un coup	English	English
d'épée la recrue	English	English
se bat bien	French	4.5
il n'a plus	French	4.5
rien à craindre	French	4.5
qu'il soit vainqueur	French	4.5
ou vaincu mais	French	4.5
s'il a peur	French	4.5
il est perdu	French	0.5
vous a fait	French	4.5
passer par le	French	4.5
baptême de fer	English	English
Le duel est	French	4.5
cependant défendu C'est	French	4.5
une excellente raison	French	4.5
pour qu'on se	French	2.5
batte davantage qu'en	French	1.5
résultetil Rien soldats	English	English
se battent et	French	4.5
les officiers ferment	French	0.5
les yeux Ainsi	French	4.5
je n'ai rien	French	4.5
à faire Vous	French	4.5
n'avez qu'à garder	English	English
le silence sera	French	4.5
porté à l'hôpital	French	0.5
et ne dira	French	4.5
rien vos deux	French	4.5
témoins seront muets	French	1.5
comme des carpes	English	English
c'est la religion	English	English
du soldat votre	French	4.5
service comme si	French	4.5
vous n'étiez pour	French	4.5
rien dans l'affaire	French	4.5
et si de	French	4.5
apprend tout soyez	French	4.5
sûr qu'il fera	French	0.5
semblant de tout	French	2.5
ignorer Cependant le	French	4.5
chirurgien visitera les	French	4.5
blessures de Le	French	4.5
chirurgien dira que	French	4.5
a la fièvre	French	4.5
s'il guérit on	English	English
dira que la	French	4.5
fièvre l'a quitté	French	0.5
Et s'il meurt	French	0.5
Il sera mort	English	English
de la fièvre	French	4.5
BelleRose se prit	French	0.5
à rire Je	French	4.5
ne ris point	English	English
continua le caporal	English	English
j'ai déjà vu	French	4.5
mourir comme ça	French	4.5
une demidouzaine de	French	4.5
sapeurs les uns	English	English
de la fièvre	French	4.5
maligne les autres	French	4.5
de la fièvre	French	4.5
rouge fièvre rouge	English	English
est un coup	English	English
de sabre la	French	4.5
fièvre maligne est	French	4.5
un coup d'épée	French	4.5
c'est la plus	French	4.5
dangereuse fièvre est	French	4.5
la providence du	French	4.5
soldat vous coucher	English	English
VI LES Tout	French	2.5
se passa comme	French	4.5
la l'avait prédit	French	4.5
entra à l'hôpital	French	0.5
le chirurgien le	French	4.5
visita et déclara	French	4.5
qu'il était malade	English	English
d'une fièvre intermittente	English	English
de feignit de	French	4.5
croire ce qu'avait	French	4.5
dit le chirurgien	English	English
mais un jour	French	4.5
qu'il rencontra seul	French	4.5
sur le rempart	English	English
il l'interpella brusquement	French	1.5
On m'a conté	French	4.5
que tu avais	French	4.5
failli attraper la	French	4.5
fièvre ces joursci	French	4.5
prendsy garde je	French	4.5
n'aime pas qu'on	French	4.5
la donne ni	French	4.5
qu'on la reçoive	French	4.5
bon pour une	French	4.5
fois C'est fini	French	4.5
répondit hardiment l'accès	French	4.5
est passé M	French	0.5
de sourit guérit	French	4.5
et il n'en	French	4.5
fut plus question	French	0.5
Quelques mois se	French	2.5
passèrent puis un	French	4.5
an puis deux	French	4.5
puis trois BelleRose	English	English
écrivait fréquemment à	French	2.5
dans les réponses	French	4.5
qu'il en recevait	French	1.5
il y avait	French	4.5
toujours quelque souvenir	French	4.5
de un mot	English	English
une fleur de	French	4.5
la saison nouvelle	French	4.5
quelque chose qui	French	4.5
venait du coeur	English	English
et qui allait	French	0.5
au coeur le	French	4.5
fils du fauconnier	French	4.5
avait dépassé la	French	4.5
de qui l'aimait	French	0.5
à sa manière	French	4.5
n'attendait plus disaitil	French	0.5
que l'occasion de	French	4.5
lui faire casser	French	2.5
la tête au	French	4.5
service du roi	French	4.5
pour demander l'épaulette	French	4.5
en sa faveur	French	4.5
appelait une bataille	French	4.5
de ses voeux	French	4.5
mais l'Espagnol se	French	2.5
tenait sur la	French	4.5
frontière fort paisible	French	0.5
dans ses quartiers	English	English
les généraux le	French	4.5
tour des ambassadeurs	English	English
était venu lieu	French	4.5
de guerroyer on	English	English
négociait s'était marié	French	0.5
La paix ne	French	4.5
faisait point les	French	4.5
affaires de aussi	French	4.5
enrageaitil de tout	French	2.5
son coeur de	French	4.5
le matin après	French	4.5
la lecture du	French	4.5
rapport voyait soucieux	French	4.5
il lui demandait	French	4.5
si les nouvelles	French	4.5
étaient à la	French	4.5
guerre Point répondait	French	4.5
le sergent il	French	2.5
serait bien temps	French	2.5
de donner des	French	4.5
quenouilles aux soldats	English	English
au moins seraientils	French	4.5
bons à quelque	French	4.5
chose Voilà un	French	4.5
drôle qui pour	French	4.5
allumer plus vite	French	0.5
le flambeau de	French	4.5
l'hyménée mettrait volontiers	French	4.5
le feu aux	French	4.5
quatre coins de	French	4.5
l'Europe répondait gaiement	French	0.5
de Mais aussitôt	French	4.5
que le sergent	French	0.5
devenait trop morose	English	English
le capitaine lui	French	4.5
confiait le commandement	French	4.5
de petits détachements	French	0.5
qu'on envoyait pour	French	4.5
le service des	French	4.5
fortifications à à	French	2.5
à à et	French	4.5
autres villes de	French	4.5
la et de	French	4.5
l'Artois Sur ces	French	4.5
entrefaites reçut une	French	4.5
lettre dont la	French	4.5
suscription lui fit	English	English
battre le coeur	English	English
il venait de	French	4.5
reconnaître l'écriture de	French	4.5
C'était la première	French	4.5
fois qu'elle lui	French	4.5
écrivait directement y	French	0.5
a dans la	French	4.5
première lettre de	French	4.5
la première femme	French	4.5
aimée une douceur	French	1.5
infinie qui mouille	French	4.5
les yeux de	French	4.5
larmes divines apporte	French	2.5
une indéfinissable émotion	French	0.5
qu'aucune chose ne	French	4.5
peut remplacer désormais	French	4.5
les doigts caressent	English	English
le papier la	French	4.5
bouche l'effleure il	French	2.5
s'en échappe un	French	4.5
parfum que l'âme	French	4.5
aspire et c'est	French	4.5
un enchantement dont	French	4.5
le souvenir réchauffe	French	4.5
le coeur des	French	4.5
plus tristes vieillards	English	English
baisa mille fois	French	4.5
cette lettre avant	French	4.5
d'en briser le	French	4.5
cachet puis il	French	2.5
courut dans la	French	4.5
campagne pour donner	French	4.5
à ses confuses	English	English
mais bienheureuses sensations	French	0.5
le silence qui	French	4.5
permet de les	French	4.5
savourer il se	French	2.5
fut blotti à	French	2.5
l'ombre des tilleuls	French	2.5
loin des chemins	English	English
poudreux par où	French	4.5
s'épanche le bruit	English	English
des villes il	French	2.5
déchira l'enveloppe et	French	4.5
lut ce qui	French	4.5
suit vous êtes	French	4.5
parti de mon	French	4.5
ami vous aviez	French	4.5
dixhuit ans j'en	French	4.5
avais quinze alors	French	2.5
plus de trois	French	4.5
ans se sont	French	4.5
écoulés depuis cet	French	4.5
instant et il	French	2.5
ne s'est pas	French	4.5
passé un seul	French	4.5
jour sans que	French	4.5
ma pensée se	French	2.5
soit arrêtée sur	French	4.5
vous souvenir habite	English	English
mon coeur comme	French	4.5
je vis dans	French	4.5
le vôtre chaque	French	4.5
fois que vos	French	4.5
lettres annonçaient vos	French	4.5
progrès et votre	French	4.5
avancement je me	French	4.5
suis réjouie heureuse	French	4.5
de vos succès	French	0.5
et fière d'avoir	French	4.5
placé ma tendresse	French	2.5
sur un être	French	4.5
qui la méritait	French	4.5
la solitude ma	French	4.5
pensée s'est mûrie	French	4.5
mon ami que	French	4.5
nous avons rêvé	French	4.5
ensemble et que	French	4.5
nous nous étions	French	4.5
promis l'un à	French	2.5
l'autre d'atteindre cet	French	4.5
avenir m'est toujours	French	4.5
doux et c'est	French	4.5
vers lui que	French	4.5
se reportent mes	French	4.5
illusions quand je	French	4.5
veux goûter une	French	4.5
heure de tranquille	French	4.5
bonheur berce le	French	4.5
coeur comme une	French	4.5
mère son enfant	English	English
mon amie la	French	4.5
confidente de mes	French	4.5
songes les anime	English	English
souvent de sa	French	4.5
joyeuse parole et	French	4.5
leur donne alors	French	2.5
toutes les trompeuses	English	English
espérances de la	French	4.5
réalité nous trouve	French	4.5
bien des fois	French	4.5
causant tout bas	French	2.5
le long des	French	4.5
haies où babillent	English	English
les oiseaux bien	French	4.5
des fois le	French	4.5
crépuscule nous surprend	English	English
encore dans les	French	4.5
prés marchant les	French	4.5
mains entrelacées et	French	4.5
toutes deux nous	French	4.5
regardons les bandes	English	English
d'or qui s'éteignent	French	4.5
et le dernier	French	4.5
sourire du soleil	English	English
qui luit au	French	4.5
sommet des peupliers	French	1.5
a votre nom	English	English
sur les lèvres	French	4.5
et m'embrasse il	French	2.5
est dans mon	French	4.5
coeur et je	French	4.5
me tais à	French	2.5
mon père il	French	2.5
passe son temps	French	2.5
à s'informer du	French	4.5
prix des denrées	French	4.5
pour accroître sa	French	4.5
fortune que je	French	4.5
trouve déjà trop	French	2.5
considérable m'assure que	French	4.5
c'est pour mon	French	4.5
bonheur et je	French	4.5
ne peux pas	French	4.5
lui faire entendre	French	4.5
raison làdessus achète	French	4.5
un jour du	French	4.5
foin et le	French	4.5
lendemain du blé	French	4.5
puis il revend	English	English
le tout avec	French	2.5
de gros bénéficesC'est	French	4.5
pour ta dot	French	1.4999999999999998
me ditilUne dot	French	1.4999999999999998
qui est déjà	French	4.5
trop grosse une	French	4.5
chose étrange les	French	4.5
personnes qui nous	French	4.5
sont le plus	French	4.5
attachées agissent suivant	French	4.5
leur fantaisie quand	English	English
elles croient agir	French	1.5
pour notre bien	French	4.5
et travaillent à	French	2.5
satisfaire leur goût	French	4.5
lorsqu'elles prétendent travailler	French	4.5
à notre bonheur	French	2.5
voudrais allonger cette	French	4.5
lettre pour retarder	English	English
le moment où	French	4.5
je dois vous	French	4.5
entretenir de l'affaire	French	4.5
qui nous touche	English	English
le plus près	French	4.5
l'un et l'autre	French	4.5
à quoi bon	English	English
faudratil pas toujours	French	4.5
que je contraigne	English	English
mon esprit à	French	2.5
vous en instruire	French	1.5
l'honnêteté l'exige vous	French	4.5
aurez lu cette	French	4.5
lettre jusqu'au bout	English	English
vous pleurerez sur	French	4.5
moi sur vous	French	4.5
mais vous m'absoudrez	French	4.5
volonté s'est soumise	English	English
au mal elle	French	4.5
ne l'a pas	French	4.5
fait savez quelle	French	4.5
fut la réponse	French	4.5
de mon père	French	4.5
à votre proposition	French	4.5
depuis ce jour	French	4.5
il ne m'a	French	4.5
jamais entretenue de	French	4.5
votre amour et	French	4.5
de vos espérances	French	4.5
seulement quand on	English	English
lui parlait des	French	4.5
progrès que vous	French	4.5
faisiez dans l'estime	French	0.5
de vos chefs	English	English
il disait que	French	4.5
cela ne l'étonnait	French	4.5
point et que	French	4.5
vous étiez un	French	4.5
garçon à parvenir	French	4.5
à tout ces	French	4.5
momentslà je me	French	4.5
sentais des envies	French	1.5
extraordinaires de l'embrasser	English	English
y a quelque	French	4.5
temps de en	French	4.5
revenant d'un voyage	French	1.4999999999999998
qu'il avait entrepris	French	4.5
à me présenta	French	4.5
un jeune gentilhomme	French	4.5
de bonne mine	French	2.5
instinct secret l'instinct	English	English
du coeur sans	French	4.5
doute me dit	French	1.5
que ce jeune	French	4.5
seigneur ne venait	French	4.5
point à pour	French	4.5
affaires de commerce	French	0.5
et je sentis	French	0.5
mon coeur se	French	2.5
serrer jeune seigneur	English	English
avait l'esprit très	French	4.5
vif tourné à	French	2.5
la galanterie railleur	French	4.5
plaisant dans ses	French	4.5
propos et tout	French	2.5
à fait l'air	French	4.5
d'un homme de	French	4.5
bon lieu mais	French	4.5
on voyait qu'il	French	4.5
parlait avant de	French	4.5
réfléchir et qu'il	French	4.5
était surtout occupé	French	4.5
de plaisirs et	French	4.5
de choses futiles	English	English
resta huit ou	French	4.5
dix jours au	French	4.5
château pendant lesquels	French	4.5
il ne me	French	4.5
fut guère possible	English	English
de me promener	English	English
avec si ce	French	4.5
n'est parfois le	French	4.5
matin de très	French	4.5
bonne heure ou	French	4.5
le soir tandis	English	English
que l'étranger rendait	French	4.5
visite à la	French	4.5
noblesse de bout	English	English
de ce temps	French	2.5
le gentilhomme partit	French	0.5
je respirais à	French	2.5
peine que déjà	French	4.5
un grave seigneur	English	English
le remplaçait au	French	4.5
château était pour	French	4.5
le moins aussi	French	4.5
sédentaire que l'autre	French	4.5
était ingambe il	French	2.5
avait l'humeur douce	English	English
égale et bonne	French	4.5
l'air d'une bienveillance	French	4.5
extrême et quoique	French	4.5
souffrant d'anciennes blessures	English	English
le maintien noble	English	English
et aisé discours	English	English
étaient enjoués mais	French	4.5
toujours honnêtes ses	French	4.5
manières polies et	French	4.5
l'on se sentait	French	4.5
attiré par l'expression	French	1.5
de sa physionomie	English	English
en même temps	French	2.5
que saisi de	French	4.5
respect à la	French	4.5
vue de ses	French	4.5
moustaches grises et	French	4.5
des cicatrices qui	French	4.5
sillonnaient son front	French	0.5
chauve seigneur se	French	2.5
nommait d'Albergotti était	French	4.5
marquis appartenait à	French	2.5
une famille d'origine	English	English
italienne qui avait	French	4.5
tenu un rang	English	English
considérable dans le	French	4.5
et portait le	French	4.5
cordon de d'Albergotti	English	English
avait beaucoup voyagé	French	4.5
sa conversation était	French	4.5
intéressante sa bonté	French	4.5
me touchait et	French	4.5
j'éprouvai quelque peine	French	2.5
quand il quitta	English	English
pour se rendre	French	2.5
à où de	French	4.5
le mandait n'était	French	4.5
parti que depuis	French	4.5
la veille lorsque	French	4.5
mon père me	French	4.5
prenant sous le	French	4.5
bras me fit	English	English
descendre au jardin	French	0.5
savez que ce	French	4.5
n'est pas son	French	4.5
habitude aussitôt qu'il	French	4.5
a une heure	French	4.5
sans emploi il	French	2.5
s'enferme dans son	French	4.5
cabinet et tout	French	2.5
aussitôt une ou	French	4.5
deux feuilles de	French	4.5
papier sont couvertes	French	4.5
de chiffres le	French	4.5
regardai étonnée il	French	2.5
se mit à	French	2.5
rire me ditil	French	4.5
j'ai à te	French	2.5
parler de choses	French	0.5
très sérieuses début	French	4.5
augmenta ma surprise	English	English
et sans savoir	French	4.5
pourquoi j'eus peur	French	4.5
songé à te	French	2.5
marier reprit mon	French	4.5
père tu viens	French	4.5
de voir tes	English	English
deux prétendants le	French	4.5
comte de et	French	4.5
d'Albergotti m'écriaije plus	French	4.5
morte que vive	English	English
mon enfant crois	French	4.5
que si mon	French	4.5
père ne m'avait	French	4.5
pas soutenue je	French	4.5
serais tombée êtes	French	4.5
une petite folle	English	English
continuatil en me	French	4.5
faisant asseoir sur	French	4.5
un banc le	French	4.5
mariage atil donc	French	4.5
rien de si	French	4.5
effrayant ne prétends	French	4.5
pas d'ailleurs contraindre	French	4.5
votre goût choisirez	French	4.5
entre le comte	English	English
et le marquis	French	4.5
atterrée et ne	French	4.5
savais que répondre	French	4.5
larmes jaillirent de	French	4.5
mes yeux et	French	4.5
je me cachai	French	4.5
la tête entre	French	4.5
les mains père	French	4.5
se mit à	French	2.5
battre la terre	French	2.5
avec le bout	English	English
de sa canne	English	English
ma fille sois	French	4.5
raisonnable repritil j'aime	French	0.5
beaucoup et je	French	4.5
suis tout prêt	French	4.5
à le lui	French	4.5
prouver mais en	French	4.5
conscience tu ne	French	4.5
peux pas l'épouser	French	0.5
donc quel beau	French	2.5
mariage ça ferait	French	4.5
ne vous répéterai	French	4.5
pas tout ce	French	4.5
qu'il me dit	French	1.5
pour m'amener à	French	2.5
son opinion je	French	4.5
n'entendais rien et	French	4.5
ne voyais que	French	4.5
vous qui me	French	4.5
sembliez debout devant	French	0.5
moi ajoutatil en	French	4.5
terminant tu seras	English	English
marquise ou comtesse	English	English
c'est une consolation	English	English
promis de l'attendre	French	4.5
m'écriaije suffoquée par	French	4.5
les larmes voilà	French	4.5
bien une autre	French	4.5
folie répliqua mon	French	4.5
père et làdessus	French	4.5
il me tint	English	English
cent autres discours	English	English
que dans ce	French	4.5
momentlà je ne	French	4.5
compris guère mais	French	4.5
qui depuis me	French	4.5
sont revenus à	French	2.5
la mémoire et	French	4.5
que je ne	French	4.5
vous rapporterai pas	French	4.5
tout au long	English	English
prétend que les	French	4.5
pères n'en tiennent	French	4.5
jamais d'autres à	French	2.5
leurs enfants les	French	4.5
pères je veux	French	4.5
bien le croire	French	4.5
mais les mères	French	4.5
c'est impossible de	French	4.5
grands discours sur	French	4.5
notre fortune et	French	4.5
sur le bonheur	French	2.5
que je goûterais	French	4.5
étant riche et	French	4.5
titrée tout cela	French	4.5
était dit sans	French	4.5
méchanceté aucune et	French	4.5
de la meilleure	French	4.5
foi du monde	French	4.5
de me quitta	English	English
j'étais comme étourdie	French	4.5
bout d'une heure	French	4.5
le trouble de	French	4.5
mes esprits se	French	2.5
calma et je	French	4.5
me fis tout	French	2.5
haut à moimême	French	4.5
la promesse de	French	4.5
n'épouser jamais que	French	4.5
vous le soir	French	4.5
très résolue à	French	2.5
suivre mon projet	French	4.5
je me rendis	English	English
chez vous pour	French	4.5
raconter ce qui	French	4.5
se passait à	French	2.5
fut votre père	French	4.5
qui me reçut	French	4.5
devinsje mon ami	English	English
lorsque je l'entendis	French	0.5
m'exhorter à vous	French	4.5
oublier résistai alors	French	2.5
prenant mes mains	French	4.5
dans les siennes	French	4.5
et courbant son	French	4.5
front chargé de	French	4.5
cheveux blancs devant	French	0.5
le mien il	French	2.5
me supplia d'obéir	French	4.5
à de au	French	4.5
nom de son	French	4.5
propre honneur à	French	2.5
lui au nom	English	English
du vôtre ne	French	4.5
voulait pas que	French	4.5
l'on pût porter	French	4.5
contre lui l'accusation	English	English
d'avoir toléré notre	French	4.5
mutuelle tendresse ni	French	4.5
que l'on vous	French	4.5
supposât coupable d'avoir	French	4.5
abusé de la	French	4.5
confiance de mon	French	4.5
père dans l'espoir	French	4.5
de m'épouser pour	French	4.5
augmenter votre fortune	English	English
m'assura que jamais	French	1.5
il ne consentirait	French	4.5
à l'union de	French	4.5
son fils avec	French	2.5
une personne qui	French	4.5
le choisirait contre	French	4.5
le gré de	French	4.5
sa famille j'ai	French	4.5
vu pleurer ce	French	4.5
vieillard mon ami	English	English
et je me	French	4.5
suis retirée toute	French	2.5
bouleversée mon isolement	English	English
je me suis	French	4.5
jetée aux pieds	English	English
d'un vieux prêtre	French	4.5
mon confesseur m'a	French	4.5
écoutée avec une	French	4.5
pieuse charitéÉlevez votre	French	4.5
âme à m'atil	French	2.5
dit et faiteslui	French	4.5
une offrande de	French	4.5
vos douleurs les	French	4.5
enfants doivent obéissance	French	4.5
à leurs parents	French	1.5
instant j'ai eu	French	0.5
la pensée de	French	4.5
prendre le voile	French	1.5
mais j'ai compris	French	4.5
que si je	French	4.5
me donnais à	French	2.5
j'étais perdue pour	French	4.5
vous moment où	French	4.5
j'étais le plus	French	4.5
tourmentée votre soeur	English	English
vint à moi	French	4.5
n'était plus la	French	4.5
jeune fille rieuse	French	4.5
et folâtre que	French	4.5
vous avez connue	French	4.5
yeux étaient rouges	English	English
à force d'avoir	French	4.5
pleuréSuzanne me ditelle	French	4.5
c'est votre devoir	French	4.5
d'obéir vous aime	English	English
trop bien pour	French	4.5
ne pas vous	French	4.5
pardonnerMon père arriva	French	0.5
compris qu'il attendait	French	4.5
ma réponse je	French	4.5
me jetai dans	French	4.5
ses bras en	French	4.5
pleurant m'embrassa sur	French	4.5
le front sa	French	4.5
joie fut ma	French	4.5
seule consolation à	French	2.5
cette heure suprêmeLequel	French	4.5
astu choisi me	French	4.5
ditilHélas je n'y	English	English
avais seulement pas	French	4.5
songé deux gentilshommes	English	English
se représentèrent à	French	2.5
ma pensée de	French	4.5
était jeune et	French	4.5
superbe l'autre était	French	4.5
vieux et souffrant	French	4.5
n'hésitai pasM d'Albergotti	English	English
répondisjeMon père parut	French	1.5
étonné mais il	French	2.5
ne manifesta pas	French	4.5
autrement sa surprise	English	English
que par un	French	4.5
mouvement des lèvresSoit	French	4.5
ditil je vais	French	4.5
lui écrireDeux jours	French	4.5
après d'Albergotti revint	English	English
à vous dois	French	4.5
de la reconnaissance	French	4.5
me ditil mais	French	4.5
soyez certaine que	French	4.5
je m'efforcerai de	French	4.5
vous donner autant	French	0.5
de bonheur que	French	4.5
vous en pouvez	French	4.5
espérer d'un pèreSa	French	4.5
voix et le	French	4.5
regard qui accompagna	French	0.5
ces paroles me	French	4.5
touchèrent profondément et	French	4.5
je mis ma	French	4.5
main dans la	French	4.5
sienne du courage	English	English
mon ami l'honneur	French	4.5
et le devoir	French	4.5
m'ordonnaient de faire	French	4.5
ce que j'ai	French	4.5
fait vous souffrirez	French	4.5
avec moi sans	French	4.5
me condamner nous	French	4.5
habituerons à ne	French	4.5
penser l'un à	French	2.5
l'autre que comme	French	4.5
un frère pense	French	4.5
à sa soeur	English	English
serez le mien	French	4.5
et nul autre	French	4.5
que vous et	French	4.5
mon mari n'entrera	French	4.5
dans un coeur	English	English
qui se réfugie	French	4.5
en dans trois	French	4.5
jours je serai	French	4.5
la femme d'un	French	4.5
autre il ne	French	4.5
me sera plus	French	4.5
permis de vous	French	4.5
écrire pitié ne	French	4.5
vous laissez pas	French	4.5
aller au désespoir	French	4.5
le vôtre me	French	4.5
rendrait folle et	French	4.5
c'est à peine	French	2.5
si déjà je	French	4.5
conserve assez de	French	4.5
raison pour vous	French	4.5
exhorter au sacrifice	English	English
part n'estelle pas	French	4.5
la plus amère	French	4.5
restez libre libre	French	4.5
d'aimer et je	French	4.5
m'enchaîne Lorsque eut	French	4.5
terminé cette lecture	French	4.5
il se leva	French	0.5
figure était blanche	English	English
comme un cierge	French	4.5
aucune larme n'éteignait	French	4.5
l'éclat fiévreux de	French	4.5
ses regards lui	French	4.5
qui s'attendrissait aisément	French	4.5
devant les émotions	French	0.5
faciles demeura impassible	French	0.5
en face de	French	4.5
cette douleur profonde	French	2.5
qui déchirait tout	French	2.5
son être marcha	French	0.5
d'un pas rapide	French	4.5
mais ferme vers	English	English
la maison de	French	4.5
de et entra	French	0.5
capitaine travaillait nom	English	English
que lui jeta	French	1.5
le sapeur de	French	4.5
planton de sans	French	4.5
se retourner demanda	English	English
à ce qu'il	French	4.5
voulait Un congé	French	0.5
répondit le sergent	French	0.5
Hein fit le	French	4.5
capitaine veux un	French	4.5
congé Oui monsieur	French	4.5
Le capitaine quitta	English	English
son bureau la	French	4.5
voix de lui	French	4.5
avait paru altérée	French	4.5
l'expression de son	French	4.5
visage l'étonna Qu'astu	French	1.5
lui ditil Il	French	2.5
faut que je	French	4.5
parte pour Aujourd'hui	French	4.5
A l'instant Et	French	4.5
si je ne	French	4.5
voulais pas te	French	2.5
donner ce congé	French	0.5
Je recommanderais mon	French	4.5
âme à mon	French	4.5
corps à d'Assonville	English	English
et me ferais	French	4.5
sauter la cervelle	French	4.5
après Il n'y	English	English
aurait peutêtre pas	French	4.5
grand mal à	French	2.5
cela ce serait	French	4.5
autant de besogne	English	English
épargnée à mes	French	4.5
sapeurs J'attends mon	French	4.5
capitaine reprit M	French	0.5
de le regarda	English	English
une minute c'était	French	4.5
un homme qui	French	4.5
se connaissait en	French	4.5
physionomies l'expression de	French	4.5
celle du sergent	French	0.5
lui fit comprendre	French	4.5
que avait pris	French	4.5
une résolution irrévocable	English	English
et que cette	French	4.5
résolution partait d'une	French	4.5
secousse violente aimait	French	0.5
le fils du	French	4.5
vieux fauconnier plus	French	4.5
qu'il ne le	French	4.5
laissait voir il	French	2.5
se décida donc	French	4.5
surlechamp Mais que	French	4.5
se passetil à	French	2.5
repritil Mlle de	French	4.5
se marie Eh	French	2.5
bien qu'estce que	French	4.5
ça te fait	French	4.5
Je l'aime Ah	English	English
voilà une excellente	English	English
raison toutes les	French	4.5
folies que les	French	4.5
hommes entreprennent cherchez	French	4.5
et vous trouverez	French	4.5
une femme BelleRose	English	English
que ferastu à	French	2.5
Je la verrai	French	4.5
Et si elle	French	4.5
ne veut pas	French	4.5
te recevoir Il	French	2.5
adviendra ce que	French	4.5
voudra C'est de	French	4.5
la frénésie frère	French	4.5
et toi vous	French	4.5
m'aviez bien conté	French	4.5
cette histoire mais	French	4.5
je l'avais presque	French	4.5
oubliée amour de	French	4.5
soldat mais c'est	French	4.5
une fleur d'automne	English	English
BelleRose regarda la	French	4.5
pendule ce mouvement	French	4.5
n'échappa point à	French	2.5
de Nancrais Eh	French	2.5
mon garçon il	French	2.5
n'y a qu'un	French	4.5
quart d'heure C'est	French	4.5
une lieue Le	French	4.5
capitaine s'approcha de	French	4.5
la table écrivit	French	4.5
quelques mots sur	French	4.5
un bout de	French	4.5
papier et signa	French	4.5
Vat'en au diable	English	English
ditil à en	French	4.5
lui donnant le	French	4.5
papier Mais au	French	4.5
moment où se	French	2.5
retirait il lui	French	4.5
prit la main	French	1.5
Tu es le	French	4.5
fils du vieux	French	4.5
mon ami ne	French	4.5
fais pas de	French	4.5
sottise tu nous	French	4.5
affligerais d'Assonville et	French	4.5
moi tu as	English	English
l'âme honnête aie	French	4.5
le coeur fort	English	English
BelleRose serra la	French	4.5
main de de	French	4.5
et s'élança hors	English	English
de l'appartement	English	English
